ticker,negative,neutral,positive,fact,opinion,volume,conviction,extremity
SAP,6,4,21,6,25,31,0.8065,0.25
SYF,6,1,10,4,13,17,0.7647,1.0
LMT,9,3,6,6,12,18,0.6667,0.3333
KMB,2,0,2,0,4,4,1.0,1.0
GM,11,7,23,12,29,41,0.7073,0.1429
BA,36,19,38,39,54,93,0.5806,0.0526
NVDA,65,173,218,235,221,456,0.4846,0.0058
BTCUSD,58,230,183,302,169,471,0.3588,0.0043
GS,26,70,77,100,73,173,0.422,0.0143
SPY,508,1232,698,1624,814,2438,0.3339,0.0008
AIQ,10,22,30,39,23,62,0.371,0.0455
ASEA,42,65,41,83,65,148,0.4392,0.0154
JPM,16,38,50,51,53,104,0.5096,0.0263
SPYB,7,19,2,22,6,28,0.2143,0.0526
IEV,16,31,15,42,20,62,0.3226,0.0323
MS,22,77,58,99,58,157,0.3694,0.013
C,18,84,85,120,67,187,0.3583,0.0119
BOTZ,3,7,0,9,1,10,0.1,0.1429
THNQ,24,34,20,48,30,78,0.3846,0.0294
JSTC,16,15,7,19,19,38,0.5,0.0667
HMC,3,14,12,18,11,29,0.3793,0.0714
KSA,6,5,9,6,14,20,0.7,0.2
WHR,4,1,5,6,4,10,0.4,1.0
PFBC,6,5,4,6,9,15,0.6,0.2
GD,0,2,3,3,2,5,0.4,0.5
EFSC,0,0,10,1,9,10,0.9,1.0
META,14,12,70,32,64,96,0.6667,0.0833
ELS,3,7,4,8,6,14,0.4286,0.1429
WRB,1,4,9,7,7,14,0.5,0.25
FULT,2,1,2,3,2,5,0.4,1.0
HFWA,2,3,4,3,6,9,0.6667,0.3333
BMRC,0,0,6,1,5,6,0.8333,1.0
SBUX,23,3,12,10,28,38,0.7368,0.3333
BXP,4,5,0,5,4,9,0.4444,0.2
CVLT,1,4,4,5,4,9,0.4444,0.25
PTIX,2,0,3,1,4,5,0.8,1.0
RTX,2,2,11,3,12,15,0.8,0.5
INSW,0,0,5,2,3,5,0.6,1.0
OVV,2,0,5,1,6,7,0.8571,1.0
EIX,3,0,5,0,8,8,1.0,1.0
HOPE,2,2,1,2,3,5,0.6,0.5
T,7,6,19,12,20,32,0.625,0.1667
MSFT,16,9,27,18,34,52,0.6538,0.1111
MRVL,5,5,21,10,21,31,0.6774,0.2
RLI,7,0,2,2,7,9,0.7778,1.0
QQQM,9,36,22,49,18,67,0.2687,0.0278
EEMA,51,39,46,62,74,136,0.5441,0.0256
ITA,3,2,2,5,2,7,0.2857,0.5
GXC,65,118,104,156,131,287,0.4564,0.0085
IYE,9,21,4,25,9,34,0.2647,0.0476
HUC.TO,48,57,27,72,60,132,0.4545,0.0175
CHIK,1,5,17,6,17,23,0.7391,0.2
NDAQ,5,1,6,4,8,12,0.6667,1.0
RYAAY,1,1,5,1,6,7,0.8571,1.0
BAC,69,122,154,194,151,345,0.4377,0.0082
UBS,12,62,42,79,37,116,0.319,0.0161
JBLU,5,0,12,2,15,17,0.8824,1.0
SOFI,3,2,9,6,8,14,0.5714,0.5
ARE,2,3,10,7,8,15,0.5333,0.3333
GGG,2,0,3,1,4,5,0.8,1.0
NTRA,4,5,8,12,5,17,0.2941,0.2
USCB,0,0,5,0,5,5,1.0,1.0
PCH,1,2,5,3,5,8,0.625,0.5
HBAN,1,5,9,9,6,15,0.4,0.2
PCYO,8,3,2,3,10,13,0.7692,0.3333
NUE,6,0,7,2,11,13,0.8462,1.0
CDLX,8,2,0,2,8,10,0.8,0.5
GNS,1,2,2,3,2,5,0.4,0.5
GBCI,0,3,6,4,5,9,0.5556,0.3333
HIMS,0,2,7,3,6,9,0.6667,0.5
MOFG,0,0,5,2,3,5,0.6,1.0
LAKE,1,1,8,3,7,10,0.7,1.0
BY,1,2,5,4,4,8,0.5,0.5
OCFC,2,5,1,5,3,8,0.375,0.2
MOG-A,1,1,3,2,3,5,0.6,1.0
JNJ,8,6,14,11,17,28,0.6071,0.1667
CELUW,0,1,5,1,5,6,0.8333,1.0
NXTT,5,1,0,1,5,6,0.8333,1.0
LKFN,0,1,4,1,4,5,0.8,1.0
DJT,14,4,3,8,13,21,0.619,0.25
SPFI,2,3,5,3,7,10,0.7,0.3333
INVH,1,3,1,4,1,5,0.2,0.3333
TWLO,0,1,7,1,7,8,0.875,1.0
VZ,11,7,21,17,22,39,0.5641,0.1429
KMI,4,8,17,15,14,29,0.4828,0.125
HCA,1,3,1,3,2,5,0.4,0.3333
DFS,2,1,12,3,12,15,0.8,1.0
CSX,8,2,5,4,11,15,0.7333,0.5
GE,0,2,3,3,2,5,0.4,0.5
ISRG,3,0,6,0,9,9,1.0,1.0
FCNCA,3,3,7,5,8,13,0.6154,0.3333
TXN,12,3,4,5,14,19,0.7368,0.3333
APD,0,1,7,1,7,8,0.875,1.0
AAPL,78,97,132,149,158,307,0.5147,0.0103
DOCN,2,0,8,1,9,10,0.9,1.0
SMCI,19,20,35,36,38,74,0.5135,0.05
VG,0,1,3,2,2,4,0.5,1.0
BFST,0,1,4,2,3,5,0.6,1.0
NCLH,1,3,4,3,5,8,0.625,0.3333
CNX,2,2,0,2,2,4,0.5,0.5
NTRS,0,2,8,3,7,10,0.7,0.5
OXY,6,1,1,1,7,8,0.875,1.0
PLD,5,5,11,8,13,21,0.619,0.2
HYMTF,3,0,2,1,4,5,0.8,1.0
FCX,6,0,8,3,11,14,0.7857,1.0
CRM,6,27,39,37,35,72,0.4861,0.037
APLS,0,2,3,3,2,5,0.4,0.5
NEP,4,2,6,6,6,12,0.5,0.5
COF,3,5,11,9,10,19,0.5263,0.2
DWTX,0,1,5,1,5,6,0.8333,1.0
CHSN,5,1,0,1,5,6,0.8333,1.0
LYTS,1,2,2,4,1,5,0.2,0.5
WKSP,3,0,5,0,8,8,1.0,1.0
WK,3,1,1,3,2,5,0.4,1.0
COSM,1,1,3,2,3,5,0.6,1.0
ELV,4,1,5,4,6,10,0.6,1.0
FCCO,0,1,4,2,3,5,0.6,1.0
APH,0,1,9,2,8,10,0.8,1.0
AA,3,2,12,5,12,17,0.7059,0.5
PLTR,5,30,36,38,33,71,0.4648,0.0333
ALLY,4,2,3,3,6,9,0.6667,0.5
PII,6,1,2,2,7,9,0.7778,1.0
VEEV,2,3,13,7,11,18,0.6111,0.3333
TSLA,71,130,224,208,217,425,0.5106,0.0077
CACI,1,0,7,1,7,8,0.875,1.0
NFLX,8,14,74,28,68,96,0.7083,0.0714
HBT,1,0,4,1,4,5,0.8,1.0
NEE,4,1,4,2,7,9,0.7778,1.0
TXT,6,2,2,4,6,10,0.6,0.5
AXP,4,1,19,4,20,24,0.8333,1.0
CATY,5,9,1,10,5,15,0.3333,0.1111
BKR,4,0,6,5,5,10,0.5,1.0
HXL,1,0,7,1,7,8,0.875,1.0
DIS,9,32,19,35,25,60,0.4167,0.0312
LEN,9,4,15,8,20,28,0.7143,0.25
WNS,3,2,0,3,2,5,0.4,0.5
UNP,0,1,4,2,3,5,0.6,1.0
HZO,3,5,2,8,2,10,0.2,0.2
CMA,9,4,6,6,13,19,0.6842,0.25
HAL,2,2,1,2,3,5,0.6,0.5
STFS,6,0,0,0,6,6,1.0,1.0
BLBX,0,0,3,0,3,3,1.0,1.0
STX,4,5,9,7,11,18,0.6111,0.2
UAL,1,0,8,2,7,9,0.7778,1.0
CRNC,4,0,5,1,8,9,0.8889,1.0
AMZN,15,19,28,28,34,62,0.5484,0.0526
GDDFF,1,1,3,2,3,5,0.6,1.0
CNS,0,3,1,4,0,4,0.0,0.3333
EWJ,8,19,10,23,14,37,0.3784,0.0526
IXN,13,29,45,46,41,87,0.4713,0.0345
GOOG,12,43,44,57,42,99,0.4242,0.0233
USDXUSD,48,68,45,106,55,161,0.3416,0.0147
ORCL,9,21,46,34,42,76,0.5526,0.0476
SNOW,7,4,22,9,24,33,0.7273,0.25
QGEN,0,2,3,3,2,5,0.4,0.5
AGYS,0,1,3,2,2,4,0.5,1.0
ABT,0,1,24,5,20,25,0.8,1.0
SLG,2,3,5,6,4,10,0.4,0.3333
WSBC,1,2,2,2,3,5,0.6,0.5
FBK,2,1,2,2,3,5,0.6,1.0
V,10,8,36,14,40,54,0.7407,0.125
CBU,0,0,5,1,4,5,0.8,1.0
HGAS,5,3,4,4,8,12,0.6667,0.3333
GOEV,5,1,0,1,5,6,0.8333,1.0
WSM,5,2,10,2,15,17,0.8824,0.5
FSLR,10,1,8,4,15,19,0.7895,1.0
SCHW,2,2,17,4,17,21,0.8095,0.5
RDDT,1,4,23,6,22,28,0.7857,0.25
DHI,4,1,5,4,6,10,0.6,1.0
MMM,7,5,13,11,14,25,0.56,0.2
KEY,4,0,6,3,7,10,0.7,1.0
AEE,0,0,4,0,4,4,1.0,1.0
GOOGL,21,29,62,54,58,112,0.5179,0.0345
NRG,1,1,7,4,5,9,0.5556,1.0
CFG,1,2,10,6,7,13,0.5385,0.5
FITB,3,4,7,5,9,14,0.6429,0.25
SF,1,3,1,4,1,5,0.2,0.3333
TDY,0,3,2,4,1,5,0.2,0.3333
INDA,14,22,14,27,23,50,0.46,0.0455
TEMPUSD,0,7,6,9,4,13,0.3077,0.1429
TRV,1,1,12,4,10,14,0.7143,1.0
PRGS,0,4,6,7,3,10,0.3,0.25
TFC,5,2,6,5,8,13,0.6154,0.5
ONB,1,1,3,1,4,5,0.8,1.0
PPA,0,2,19,5,16,21,0.7619,0.5
XRPUSD,11,13,7,20,11,31,0.3548,0.0769
WIT,2,2,3,4,3,7,0.4286,0.5
AAAU,64,92,58,130,84,214,0.3925,0.0109
TSM,4,13,56,25,48,73,0.6575,0.0769
SBTCUSD,2,11,3,12,4,16,0.25,0.0909
KYN,0,5,0,5,0,5,0.0,0.2
EIS,4,4,6,6,8,14,0.5714,0.25
QEM.TO,3,5,0,6,2,8,0.25,0.2
GAS.TO,2,5,4,7,4,11,0.3636,0.2
ETHI.TO,1,7,3,8,3,11,0.2727,0.1429
AMD,28,25,32,38,47,85,0.5529,0.04
PSJ,0,5,4,6,3,9,0.3333,0.2
VITL,1,2,6,4,5,9,0.5556,0.5
OUT,0,3,1,3,1,4,0.25,0.3333
WBS,2,1,7,2,8,10,0.8,1.0
COIN,0,0,8,3,5,8,0.625,1.0
AMAT,7,7,14,10,18,28,0.6429,0.1429
FAST,10,2,2,6,8,14,0.5714,0.5
ADP,0,2,3,3,2,5,0.4,0.5
RHE-PA,0,1,5,1,5,6,0.8333,1.0
SLB,8,2,14,4,20,24,0.8333,0.5
STT,3,3,13,4,15,19,0.7895,0.3333
JBHT,6,1,3,2,8,10,0.8,1.0
LLY,3,0,11,1,13,14,0.9286,1.0
AESI,0,0,4,1,3,4,0.75,1.0
SNAP,17,7,21,10,35,45,0.7778,0.1429
RF,2,4,8,7,7,14,0.5,0.25
FHN,1,1,3,3,2,5,0.4,1.0
BOKF,0,1,4,2,3,5,0.6,1.0
INDB,1,0,4,3,2,5,0.4,1.0
OZK,1,0,4,3,2,5,0.4,1.0
JOBY,3,2,7,4,8,12,0.6667,0.5
BILL,2,2,4,4,4,8,0.5,0.5
INFY,0,1,4,2,3,5,0.6,1.0
ESTC,6,4,12,6,16,22,0.7273,0.25
IBKR,3,6,6,11,4,15,0.2667,0.1667
PNC,0,1,2,1,2,3,0.6667,1.0
MTB,1,4,19,7,17,24,0.7083,0.25
NEOG,1,0,4,3,2,5,0.4,1.0
USB,2,8,8,10,8,18,0.4444,0.125
UNH,2,3,12,10,7,17,0.4118,0.3333
FC,6,3,6,5,10,15,0.6667,0.3333
HEI,4,6,13,8,15,23,0.6522,0.1667
BK,1,0,7,1,7,8,0.875,1.0
SNV,0,1,9,2,8,10,0.8,1.0
HOMB,0,0,5,1,4,5,0.8,1.0
AIR,2,4,3,6,3,9,0.3333,0.25
BLK,2,7,15,9,15,24,0.625,0.1429
HSDT,1,1,2,1,3,4,0.75,1.0
CVGW,1,1,3,3,2,5,0.4,1.0
WFC,14,26,48,50,38,88,0.4318,0.0385
SPOT,3,1,12,4,12,16,0.75,1.0
EXEL,2,2,15,5,14,19,0.7368,0.5
S,3,1,15,1,18,19,0.9474,1.0
CHNA,8,8,2,11,7,18,0.3889,0.125
NOKIA.PA,0,5,3,5,3,8,0.375,0.2
VWA.BR,15,15,12,18,24,42,0.5714,0.0667
PFE,9,8,6,11,12,23,0.5217,0.125
JPN,10,21,5,26,10,36,0.2778,0.0476
SGOL,4,13,3,16,4,20,0.2,0.0769
ROKU,7,3,21,3,28,31,0.9032,0.3333
SOTK,1,1,3,2,3,5,0.6,1.0
HCAT,0,1,4,1,4,5,0.8,1.0
MA,2,2,18,6,16,22,0.7273,0.5
AGX,0,1,9,4,6,10,0.6,1.0
ACCD,3,2,4,5,4,9,0.4444,0.5
DASH,0,0,7,1,6,7,0.8571,1.0
ENPH,7,0,0,3,4,7,0.5714,1.0
SEMR,1,0,6,1,6,7,0.8571,1.0
RUM,2,0,7,1,8,9,0.8889,1.0
WDFC,1,1,3,2,3,5,0.6,1.0
ISRA,0,5,8,6,7,13,0.5385,0.2
DRIV,1,5,1,5,2,7,0.2857,0.2
SPGM,14,17,12,27,16,43,0.3721,0.0588
ACES,1,8,6,11,4,15,0.2667,0.125
QUS.TO,5,11,4,15,5,20,0.25,0.0909
BP,7,3,6,6,10,16,0.625,0.3333
DAL,14,5,19,11,27,38,0.7105,0.2
PENG,2,1,2,1,4,5,0.8,1.0
IRTC,0,0,5,2,3,5,0.6,1.0
HON,5,7,18,13,17,30,0.5667,0.1429
SNPS,4,0,5,0,9,9,1.0,1.0
KLAC,2,0,8,1,9,10,0.9,1.0
ONTO,0,0,4,0,4,4,1.0,1.0
LZ,1,0,3,0,4,4,1.0,1.0
CART,3,0,20,6,17,23,0.7391,1.0
PYPL,8,5,30,10,33,43,0.7674,0.2
PSX,4,0,9,2,11,13,0.8462,1.0
BRKR,3,3,4,3,7,10,0.7,0.3333
BUD,2,1,2,1,4,5,0.8,1.0
AIA,26,54,29,71,38,109,0.3486,0.0185
BMRPF,1,0,4,2,3,5,0.6,1.0
MVST,2,1,2,2,3,5,0.6,1.0
ZYBT,0,0,4,1,3,4,0.75,1.0
SNX,3,0,2,1,4,5,0.8,1.0
NKE,22,9,35,18,48,66,0.7273,0.1111
LULU,10,2,12,7,17,24,0.7083,0.5
VRNT,2,3,8,6,7,13,0.5385,0.3333
MCY,4,0,1,1,4,5,0.8,1.0
JSAIY,1,1,3,2,3,5,0.6,1.0
GH,0,0,4,0,4,4,1.0,1.0
XTIA,0,1,3,1,3,4,0.75,1.0
WBA,10,3,6,7,12,19,0.6316,0.3333
STZ,5,2,8,5,10,15,0.6667,0.5
GORO,2,0,2,2,2,4,0.5,1.0
TSCDY,2,1,7,4,6,10,0.6,1.0
DECK,3,1,18,4,18,22,0.8182,1.0
GPN,8,0,6,0,14,14,1.0,1.0
CBOE,1,1,13,3,12,15,0.8,1.0
HLIT,2,0,2,0,4,4,1.0,1.0
CHKP,0,0,3,1,2,3,0.6667,1.0
MSM,1,1,3,1,4,5,0.8,1.0
BCS,14,35,26,46,29,75,0.3867,0.0286
HSBC,19,36,59,58,56,114,0.4912,0.0278
ANGO,1,1,2,2,2,4,0.5,1.0
UNF,1,1,3,1,4,5,0.8,1.0
AMBA,3,2,9,8,6,14,0.4286,0.5
HELE,6,4,2,4,8,12,0.6667,0.25
LFCR,6,2,6,8,6,14,0.4286,0.5
ACI,4,8,6,12,6,18,0.3333,0.125
KBH,1,7,2,8,2,10,0.2,0.1429
RCEL,3,1,4,1,7,8,0.875,1.0
APOG,3,2,4,2,7,9,0.7778,0.5
ALK,0,3,10,5,8,13,0.6154,0.3333
YUM,1,0,4,2,3,5,0.6,1.0
AYI,1,5,4,7,3,10,0.3,0.2
LUV,6,2,9,7,10,17,0.5882,0.5
KRUS,0,1,4,4,1,5,0.2,1.0
KO,1,0,12,2,11,13,0.8462,1.0
SEDG,11,1,0,4,8,12,0.6667,1.0
IYY,62,85,42,120,69,189,0.3651,0.0118
BFOCX,1,4,1,5,1,6,0.1667,0.25
GETY,0,6,1,7,0,7,0.0,0.1667
ETHUSD,1,4,3,4,4,8,0.5,0.25
HMNY,5,6,0,8,3,11,0.2727,0.1667
AEHR,1,2,2,4,1,5,0.2,0.5
SUM,0,2,3,4,1,5,0.2,0.5
AZZ,1,1,8,5,5,10,0.5,1.0
CAMT,1,1,1,2,1,3,0.3333,1.0
RELL,4,0,1,0,5,5,1.0,1.0
PYCR,3,0,1,1,3,4,0.75,1.0
CMC,3,3,4,3,7,10,0.7,0.3333
JEF,4,3,6,6,7,13,0.5385,0.3333
DHAI,6,0,0,1,5,6,0.8333,1.0
DATSW,0,1,4,1,4,5,0.8,1.0
AXON,3,3,10,5,11,16,0.6875,0.3333
LH,0,0,4,0,4,4,1.0,1.0
ZION,0,0,3,0,3,3,1.0,1.0
RPM,0,2,13,6,9,15,0.6,0.5
LNN,0,2,3,3,2,5,0.4,0.5
CHWY,2,3,14,5,14,19,0.7368,0.3333
CSML,5,9,4,15,3,18,0.1667,0.1111
PTEN,0,1,4,1,4,5,0.8,1.0
ADDYY,2,0,3,3,2,5,0.4,1.0
AEIS,0,0,3,0,3,3,1.0,1.0
TSCO,0,0,7,1,6,7,0.8571,1.0
RJF,2,0,10,1,11,12,0.9167,1.0
PANW,4,3,16,7,16,23,0.6957,0.3333
LYFT,0,0,7,0,7,7,1.0,1.0
SMTC,0,1,12,4,9,13,0.6923,1.0
NVO,1,0,6,1,6,7,0.8571,1.0
PAYX,3,2,6,5,6,11,0.5455,0.5
NCNO,3,1,1,1,4,5,0.8,1.0
LFVN,0,1,3,2,2,4,0.5,1.0
CVNA,1,4,16,5,16,21,0.7619,0.25
FCPI,9,18,4,23,8,31,0.2581,0.0556
EPV,1,4,3,6,2,8,0.25,0.25
ITOT,30,37,18,54,31,85,0.3647,0.027
HUG.TO,15,27,18,37,23,60,0.3833,0.037
EWA,8,20,10,23,15,38,0.3947,0.05
IDAI,1,0,3,2,2,4,0.5,1.0
BBAI,8,4,6,6,12,18,0.6667,0.25
RIVN,7,0,6,0,13,13,1.0,1.0
PGPHF,0,2,1,2,1,3,0.3333,0.5
X,3,1,4,1,7,8,0.875,1.0
LC,1,0,2,0,3,3,1.0,1.0
NET,0,1,5,1,5,6,0.8333,1.0
NOW,0,2,13,2,13,15,0.8667,0.5
ETN,0,0,4,0,4,4,1.0,1.0
PGRE,0,1,7,3,5,8,0.625,1.0
MTAUSD,0,1,4,3,2,5,0.4,1.0
BYD,0,4,7,5,6,11,0.5455,0.25
PTEU,5,4,1,4,6,10,0.6,0.25
VLXUSD,0,4,1,4,1,5,0.2,0.25
GBX,1,4,5,7,3,10,0.3,0.25
CPNG,0,1,4,1,4,5,0.8,1.0
AISP,2,2,0,3,1,4,0.25,0.5
DPZ,3,1,7,3,8,11,0.7273,1.0
DEI,1,1,2,2,2,4,0.5,1.0
SHW,10,0,2,3,9,12,0.75,1.0
EVRG,0,0,3,0,3,3,1.0,1.0
ROK,1,0,6,0,7,7,1.0,1.0
ALAB,2,0,7,2,7,9,0.7778,1.0
SGMO,1,2,0,2,1,3,0.3333,0.5
VICI,0,1,4,1,4,5,0.8,1.0
ESGU,2,3,1,3,3,6,0.5,0.3333
ESGV,3,5,4,11,1,12,0.0833,0.2
BABA,13,33,45,55,36,91,0.3956,0.0303
GKOS,0,0,4,0,4,4,1.0,1.0
HOG,9,2,1,4,8,12,0.6667,0.5
PNFP,0,0,4,0,4,4,1.0,1.0
SEAT,1,0,3,2,2,4,0.5,1.0
GPMT,1,0,3,1,3,4,0.75,1.0
AVO,0,1,3,2,2,4,0.5,1.0
MSGE,1,0,2,0,3,3,1.0,1.0
SDA,0,0,4,0,4,4,1.0,1.0
LEGN,1,0,3,1,3,4,0.75,1.0
DOW,2,4,4,6,4,10,0.4,0.25
CDMO,4,0,5,4,5,9,0.5556,1.0
ADBE,12,4,37,10,43,53,0.8113,0.25
CFBK,3,2,5,3,7,10,0.7,0.5
IIPR,3,1,0,1,3,4,0.75,1.0
ERNA,2,2,6,2,8,10,0.8,0.5
OXBR,1,0,4,1,4,5,0.8,1.0
SATX,1,1,3,1,4,5,0.8,1.0
GERN,3,0,2,0,5,5,1.0,1.0
BFH,2,1,2,1,4,5,0.8,1.0
WMT,10,10,37,16,41,57,0.7193,0.1
INTZ,0,1,5,2,4,6,0.6667,1.0
ONON,0,0,3,0,3,3,1.0,1.0
STNE,1,0,3,0,4,4,1.0,1.0
MASI,0,0,3,0,3,3,1.0,1.0
TBBK,0,0,3,0,3,3,1.0,1.0
MMYT,1,0,2,1,2,3,0.6667,1.0
LPTH,0,0,5,0,5,5,1.0,1.0
FDX,14,12,22,18,30,48,0.625,0.0833
ACVA,0,0,3,0,3,3,1.0,1.0
CLBT,10,5,14,6,23,29,0.7931,0.2
VUZI,0,1,4,2,3,5,0.6,1.0
OKLO,3,2,3,2,6,8,0.75,0.5
CRWD,6,3,21,7,23,30,0.7667,0.3333
EAT,2,0,13,2,13,15,0.8667,1.0
EVLV,24,4,5,7,26,33,0.7879,0.25
TW,2,1,2,1,4,5,0.8,1.0
CALM,0,3,2,4,1,5,0.2,0.3333
ARDX,2,1,2,2,3,5,0.6,1.0
BAOS,0,0,5,1,4,5,0.8,1.0
DDOG,1,2,11,3,11,14,0.7857,0.5
PWR,0,0,3,0,3,3,1.0,1.0
PLYA,0,1,3,1,3,4,0.75,1.0
TOUR,4,2,3,5,4,9,0.4444,0.5
LMNR,0,0,5,3,2,5,0.4,1.0
ELVA,1,1,3,2,3,5,0.6,1.0
AGR,1,1,2,3,1,4,0.25,1.0
SCHL,5,1,3,2,7,9,0.7778,1.0
AJG,1,1,2,3,1,4,0.25,1.0
UGI,0,1,8,1,8,9,0.8889,1.0
SOUN,0,0,4,0,4,4,1.0,1.0
AYTU,2,2,1,2,3,5,0.6,0.5
FINW,2,1,2,1,4,5,0.8,1.0
SQNS,4,2,3,3,6,9,0.6667,0.5
CSWI,5,2,11,6,12,18,0.6667,0.5
LW,2,3,7,6,6,12,0.5,0.3333
LITM,1,0,3,0,4,4,1.0,1.0
CCL,2,3,10,6,9,15,0.6,0.3333
CTAS,0,3,14,5,12,17,0.7059,0.3333
ACN,1,4,20,6,19,25,0.76,0.25
KMX,3,2,4,3,6,9,0.6667,0.5
WTW,1,1,2,2,2,4,0.5,1.0
BPTH,0,3,2,5,0,5,0.0,0.3333
OPHC,4,3,8,5,10,15,0.6667,0.3333
VRTX,4,0,6,1,9,10,0.9,1.0
FDS,0,1,15,3,13,16,0.8125,1.0
THG,2,1,1,1,3,4,0.75,1.0
CAG,6,5,3,6,8,14,0.5714,0.2
KULR,2,0,2,1,3,4,0.75,1.0
MU,13,1,20,8,26,34,0.7647,1.0
MLKN,5,1,3,1,8,9,0.8889,1.0
BRLT,3,0,0,0,3,3,1.0,1.0
PATH,4,0,4,0,8,8,1.0,1.0
DRI,1,1,8,2,8,10,0.8,1.0
WOR,1,0,4,2,3,5,0.6,1.0
YCBD,2,1,1,2,2,4,0.5,1.0
WGO,1,3,1,5,0,5,0.0,0.3333
PALAF,3,1,1,2,3,5,0.6,1.0
CDNS,3,3,7,5,8,13,0.6154,0.3333
TTC,2,1,1,1,3,4,0.75,1.0
OGI,7,1,2,3,7,10,0.7,1.0
PET,2,1,0,1,2,3,0.6667,1.0
CGTX,0,1,3,3,1,4,0.25,1.0
ABM,1,0,4,1,4,5,0.8,1.0
JBL,4,2,9,5,10,15,0.6667,0.5
GIS,9,7,9,10,15,25,0.6,0.1429
BIRK,1,0,4,0,5,5,1.0,1.0
CIEN,4,2,6,2,10,12,0.8333,0.5
EXPE,0,0,6,1,5,6,0.8333,1.0
HEI-A,1,0,4,1,4,5,0.8,1.0
SBIG,1,0,4,2,3,5,0.6,1.0
PKG,0,2,12,3,11,14,0.7857,0.5
CQQQ,2,2,7,5,6,11,0.5455,0.5
APDN,3,0,2,2,3,5,0.6,1.0
AI,2,3,10,8,7,15,0.4667,0.3333
ICAGY,0,1,3,1,3,4,0.75,1.0
SRAD,2,1,2,1,4,5,0.8,1.0
FTI,0,2,6,2,6,8,0.75,0.5
ZBH,1,0,3,0,4,4,1.0,1.0
ECL,0,3,5,3,5,8,0.625,0.3333
DGX,0,0,14,1,13,14,0.9286,1.0
INTC,15,13,18,16,30,46,0.6522,0.0769
COP,1,3,9,4,9,13,0.6923,0.3333
CCX.TO,3,3,0,5,1,6,0.1667,0.3333
OPOF,3,1,1,2,3,5,0.6,1.0
BB,2,3,0,4,1,5,0.2,0.3333
MITK,0,1,4,1,4,5,0.8,1.0
RICK,0,2,3,3,2,5,0.4,0.5
MAMA,2,1,2,4,1,5,0.2,1.0
RCAT,3,0,2,1,4,5,0.8,1.0
CLSD,4,2,4,2,8,10,0.8,0.5
DRCT,0,4,0,4,0,4,0.0,0.25
F,7,2,23,7,25,32,0.7812,0.5
MCD,1,1,16,3,15,18,0.8333,1.0
OKTA,0,0,10,0,10,10,1.0,1.0
SP,3,10,2,13,2,15,0.1333,0.1
MSTR,6,12,10,16,12,28,0.4286,0.0833
LFST,1,1,3,3,2,5,0.4,1.0
THC,3,0,2,2,3,5,0.6,1.0
PATK,1,2,2,4,1,5,0.2,0.5
NAMS,4,3,3,4,6,10,0.6,0.3333
MPWR,3,1,4,1,7,8,0.875,1.0
EWY,9,3,4,9,7,16,0.4375,0.3333
VEON,0,2,3,4,1,5,0.2,0.5
IIIV,2,1,2,1,4,5,0.8,1.0
AVGO,3,1,20,2,22,24,0.9167,1.0
PLAY,7,1,2,4,6,10,0.6,1.0
CFR,5,2,3,3,7,10,0.7,0.5
ASYS,2,1,2,3,2,5,0.4,1.0
JLL,0,1,4,2,3,5,0.6,1.0
FCEL,1,1,3,2,3,5,0.6,1.0
COST,4,8,21,13,20,33,0.6061,0.125
RH,3,0,10,2,11,13,0.8462,1.0
RHI,1,0,4,1,4,5,0.8,1.0
PEP,10,4,11,8,17,25,0.68,0.25
BLUE,5,1,3,2,7,9,0.7778,1.0
WDC,1,1,6,4,4,8,0.5,1.0
EMLAF,1,1,3,2,3,5,0.6,1.0
APA,3,2,5,5,5,10,0.5,0.5
NDSN,3,1,6,2,8,10,0.8,1.0
MTCH,4,1,4,4,5,9,0.5556,1.0
LQDT,0,1,4,3,2,5,0.4,1.0
CCCS,0,1,4,2,3,5,0.6,1.0
KEYUF,0,1,4,1,4,5,0.8,1.0
JILL,0,3,2,3,2,5,0.4,0.3333
UEC,2,2,4,4,4,8,0.5,0.5
ML,2,4,3,6,3,9,0.3333,0.25
MYNA,4,1,0,1,4,5,0.8,1.0
OLLI,2,4,13,4,15,19,0.7895,0.25
CMCSA,1,4,9,7,7,14,0.5,0.25
IDEXY,2,1,7,7,3,10,0.3,1.0
BZ,0,2,8,4,6,10,0.6,0.5
LOVE,0,1,9,2,8,10,0.8,1.0
SLF,0,0,5,0,5,5,1.0,1.0
NA,0,1,3,1,3,4,0.75,1.0
GME,13,2,12,10,17,27,0.6296,0.5
TOL,4,4,9,5,12,17,0.7059,0.25
DESP,1,3,6,4,6,10,0.6,0.3333
ASHTF,4,1,0,1,4,5,0.8,1.0
MFG,0,3,5,3,5,8,0.625,0.3333
ANET,1,5,7,8,5,13,0.3846,0.2
FLAX,2,8,5,12,3,15,0.2,0.125
HOPHF,0,4,0,4,0,4,0.0,0.25
SPWH,1,1,3,2,3,5,0.6,1.0
GIII,1,2,6,7,2,9,0.2222,0.5
FERG,1,5,4,9,1,10,0.1,0.2
AQST,5,1,9,3,12,15,0.8,1.0
EMR,0,4,9,5,8,13,0.6154,0.25
CRVO,4,1,0,1,4,5,0.8,1.0
ASO,5,3,2,5,5,10,0.5,0.3333
UNFI,1,1,3,2,3,5,0.6,1.0
MDB,5,5,18,10,18,28,0.6429,0.2
HQY,2,1,6,3,6,9,0.6667,1.0
YEXT,1,0,3,1,3,4,0.75,1.0
BIIB,7,2,6,6,9,15,0.6,0.5
DLO,4,2,4,2,8,10,0.8,0.5
AZO,5,1,11,5,12,17,0.7059,1.0
NOMD,1,0,4,0,5,5,1.0,1.0
M,7,4,11,9,13,22,0.5909,0.25
PFIS,1,2,2,2,3,5,0.6,0.5
RENT,1,1,3,2,3,5,0.6,1.0
VBNK,2,0,3,2,3,5,0.6,1.0
YPF,1,0,2,0,3,3,1.0,1.0
QCOM,19,15,35,32,37,69,0.5362,0.0667
BWMN,0,0,5,3,2,5,0.4,1.0
XBI,0,2,5,3,4,7,0.5714,0.5
BYD.TO,0,2,12,3,11,14,0.7857,0.5
IEUR,0,3,5,4,4,8,0.5,0.3333
GBDC,0,6,6,7,5,12,0.4167,0.1667
DGT,4,20,8,26,6,32,0.1875,0.05
ELAN,3,2,0,3,2,5,0.4,0.5
PHR,1,1,7,4,5,9,0.5556,1.0
XTL,0,5,6,10,1,11,0.0909,0.2
BLDG,0,2,3,3,2,5,0.4,0.5
UFO,1,4,0,5,0,5,0.0,0.25
KER.PA,4,1,1,2,4,6,0.6667,1.0
EUFN,2,3,2,6,1,7,0.1429,0.3333
SPLP,0,0,10,2,8,10,0.8,1.0
EWTX,2,1,1,1,3,4,0.75,1.0
CNK,1,1,2,1,3,4,0.75,1.0
ASAN,0,0,4,0,4,4,1.0,1.0
DOCU,1,0,8,1,8,9,0.8889,1.0
GTLB,2,1,14,1,16,17,0.9412,1.0
HPE,4,3,15,4,18,22,0.8182,0.3333
IOT,1,0,9,2,8,10,0.8,1.0
ULTA,13,1,13,5,22,27,0.8148,1.0
BF-B,0,0,5,2,3,5,0.6,1.0
KR,3,2,14,6,13,19,0.6842,0.5
ETR,0,4,4,4,4,8,0.5,0.25
GDRX,4,2,4,2,8,10,0.8,0.5
BBW,0,1,4,2,3,5,0.6,1.0
LE,3,0,2,1,4,5,0.8,1.0
CSIQ,6,0,4,0,10,10,1.0,1.0
FIVE,8,6,12,10,16,26,0.6154,0.1667
PVH,4,0,5,0,9,9,1.0,1.0
CHPT,3,0,1,1,3,4,0.75,1.0
GMS,4,2,3,3,6,9,0.6667,0.5
DG,8,1,4,2,11,13,0.8462,1.0
CASY,1,2,6,6,3,9,0.3333,0.5
GEF,1,3,1,3,2,5,0.4,0.3333
DLMAF,0,1,4,1,4,5,0.8,1.0
AEO,1,1,2,3,1,4,0.25,1.0
HRL,3,1,1,3,2,5,0.4,1.0
TOST,1,0,4,1,4,5,0.8,1.0
DLTR,13,9,16,16,22,38,0.5789,0.1111
HOOD,2,3,19,5,19,24,0.7917,0.3333
PSTG,1,2,9,5,7,12,0.5833,0.5
CPB,7,2,6,3,12,15,0.8,0.5
BMY,4,0,1,1,4,5,0.8,1.0
EURL,7,3,3,5,8,13,0.6154,0.3333
OIL,4,6,3,9,4,13,0.3077,0.1667
FLUX,10,2,3,5,10,15,0.6667,0.5
CURV,6,1,3,6,4,10,0.4,1.0
BOX,1,3,11,5,10,15,0.6667,0.3333
BASE,2,1,7,3,7,10,0.7,1.0
CTRN,0,0,5,0,5,5,1.0,1.0
AFL,0,0,4,2,2,4,0.5,1.0
SHOP,0,0,10,0,10,10,1.0,1.0
VRT,2,0,6,2,6,8,0.75,1.0
FL,8,3,6,5,12,17,0.7059,0.3333
NARI,1,1,3,1,4,5,0.8,1.0
BNS,2,5,3,6,4,10,0.4,0.2
ZS,11,4,9,7,17,24,0.7083,0.25
WEC,0,0,3,1,2,3,0.6667,1.0
PROSY,1,0,4,0,5,5,1.0,1.0
CRDO,1,1,2,1,3,4,0.75,1.0
ALCO,1,1,3,2,3,5,0.6,1.0
ZUO,3,2,0,2,3,5,0.6,0.5
SLX,5,5,7,8,9,17,0.5294,0.2
HHF.TO,3,18,8,22,7,29,0.2414,0.0556
AILE,6,3,1,3,7,10,0.7,0.3333
LSPD,1,1,2,1,3,4,0.75,1.0
IBRX,3,1,6,4,6,10,0.6,1.0
IMPP,5,1,4,2,8,10,0.8,1.0
DSGX,0,0,10,1,9,10,0.9,1.0
DCI,0,0,5,0,5,5,1.0,1.0
CHH,2,3,5,5,5,10,0.5,0.3333
ZG,0,0,5,0,5,5,1.0,1.0
NU,5,3,17,4,21,25,0.84,0.3333
SYK,0,0,4,0,4,4,1.0,1.0
SQ,2,0,13,4,11,15,0.7333,1.0
SOXX,4,3,1,7,1,8,0.125,0.3333
CHIX,0,2,3,3,2,5,0.4,0.5
IYR,0,4,5,6,3,9,0.3333,0.25
INDY,2,1,0,1,2,3,0.6667,1.0
IYH,5,2,6,4,9,13,0.6923,0.5
STLA,1,4,1,5,1,6,0.1667,0.25
LTCUSD,0,4,3,4,3,7,0.4286,0.25
HBA.TO,4,3,0,4,3,7,0.4286,0.3333
AX,2,4,9,8,7,15,0.4667,0.25
BGNE,1,1,2,2,2,4,0.5,1.0
PTCT,3,0,6,3,6,9,0.6667,1.0
BIOR,2,1,2,1,4,5,0.8,1.0
CABA,0,2,5,2,5,7,0.7143,0.5
WYHG,1,1,2,2,2,4,0.5,1.0
MNSO,6,6,8,9,11,20,0.55,0.1667
CNTMF,2,1,2,2,3,5,0.6,1.0
CLSK,2,2,1,3,2,5,0.4,0.5
NAT,2,1,2,3,2,5,0.4,1.0
ADSK,7,3,11,6,15,21,0.7143,0.3333
DDD,1,0,7,0,8,8,1.0,1.0
BIDU,10,7,15,15,17,32,0.5312,0.1429
FGF,1,3,1,4,1,5,0.2,0.3333
RSGUF,1,1,3,3,2,5,0.4,1.0
GOGL,0,1,4,2,3,5,0.6,1.0
MGROF,1,1,3,3,2,5,0.4,1.0
FRO,3,4,8,8,7,15,0.4667,0.25
CMPGY,0,0,5,1,4,5,0.8,1.0
IMMR,2,1,2,2,3,5,0.6,1.0
BBY,3,2,7,2,10,12,0.8333,0.5
AXS,0,0,4,1,3,4,0.75,1.0
CLVR,0,1,4,2,3,5,0.6,1.0
DELL,17,6,26,13,36,49,0.7347,0.1667
HPQ,3,0,6,2,7,9,0.7778,1.0
JWN,3,4,11,8,10,18,0.5556,0.25
NTNX,1,0,7,1,7,8,0.875,1.0
DB,7,4,13,8,16,24,0.6667,0.25
SJM,4,3,3,3,7,10,0.7,0.3333
WDAY,3,1,20,5,19,24,0.7917,1.0
DKS,5,1,12,5,13,18,0.7222,1.0
WWD,0,3,9,5,7,12,0.5833,0.3333
ZM,3,1,15,6,13,19,0.6842,1.0
A,5,2,6,4,9,13,0.6923,0.5
HUBB,2,0,1,1,2,3,0.6667,1.0
RMBS,0,0,2,0,2,2,1.0,1.0
LESL,3,1,1,1,4,5,0.8,1.0
BLBD,0,2,8,2,8,10,0.8,0.5
AFRM,1,1,13,3,12,15,0.8,1.0
BSX,3,4,3,5,5,10,0.5,0.25
YY,1,1,6,1,7,8,0.875,1.0
FXLV,0,2,5,2,5,7,0.7143,0.5
BBWI,7,3,4,5,9,14,0.6429,0.3333
CWEN,0,0,2,0,2,2,1.0,1.0
URBN,1,2,2,2,3,5,0.6,0.5
BURL,1,1,7,5,4,9,0.4444,1.0
AGZ,0,4,4,6,2,8,0.25,0.25
USDTUSD,0,1,6,3,4,7,0.5714,1.0
ANF,1,2,12,5,10,15,0.6667,0.5
GPUS,1,3,1,5,0,5,0.0,0.3333
ADMA,2,2,1,4,1,5,0.2,0.5
SCVL,2,1,2,2,3,5,0.6,1.0
PG,6,5,8,5,14,19,0.7368,0.2
CPA,3,1,5,5,4,9,0.4444,1.0
ATR,0,2,3,2,3,5,0.6,0.5
NMHI,1,1,2,4,0,4,0.0,1.0
LIFWZ,4,1,0,1,4,5,0.8,1.0
WMG,2,0,2,1,3,4,0.75,1.0
ROST,1,1,7,4,5,9,0.5556,1.0
NTAP,0,2,13,3,12,15,0.8,0.5
DE,9,6,8,7,16,23,0.6957,0.1667
BJ,0,1,3,1,3,4,0.75,1.0
AVPT,0,2,2,2,2,4,0.5,0.5
INTU,4,3,7,5,9,14,0.6429,0.3333
TCBI,1,2,2,3,2,5,0.4,0.5
BKE,3,0,2,2,3,5,0.6,1.0
IAS,0,1,9,2,8,10,0.8,1.0
DY,1,1,3,1,4,5,0.8,1.0
DBX,2,2,3,3,4,7,0.5714,0.5
MMS,1,1,3,2,3,5,0.6,1.0
SR,3,1,1,3,2,5,0.4,1.0
NIO,6,5,17,9,19,28,0.6786,0.2
TJX,3,0,14,2,15,17,0.8824,1.0
TGT,10,6,15,8,23,31,0.7419,0.1667
WIX,0,1,11,2,10,12,0.8333,1.0
HDGE.TO,3,2,1,4,2,6,0.3333,0.5
LUXH,1,1,2,2,2,4,0.5,1.0
ROAD,1,2,2,2,3,5,0.6,0.5
DRVN,0,1,4,2,3,5,0.6,1.0
AIM,2,1,2,2,3,5,0.6,1.0
LOW,12,2,10,7,17,24,0.7083,0.5
MDT,2,1,6,2,7,9,0.7778,1.0
GFS,1,0,2,1,2,3,0.6667,1.0
BOOM,4,0,0,1,3,4,0.75,1.0
ENR,0,0,5,2,3,5,0.6,1.0
AS,0,0,3,0,3,3,1.0,1.0
MIGI,3,0,2,1,4,5,0.8,1.0
VFS,12,2,6,6,14,20,0.7,0.5
ZIM,1,0,9,3,7,10,0.7,1.0
FUTU,1,1,6,4,4,8,0.5,1.0
TCOM,0,1,11,2,10,12,0.8333,1.0
FENC,1,2,2,3,2,5,0.4,0.5
JACK,4,0,4,2,6,8,0.75,1.0
XRAY,3,0,1,1,3,4,0.75,1.0
FIX,0,1,7,1,7,8,0.875,1.0
SAVE,0,2,13,2,13,15,0.8667,0.5
FI,0,0,3,0,3,3,1.0,1.0
MGIC,0,0,3,0,3,3,1.0,1.0
XPEV,4,0,5,3,6,9,0.6667,1.0
VIPS,2,1,2,1,4,5,0.8,1.0
AWK,2,0,5,3,4,7,0.5714,1.0
EZPW,1,0,4,2,3,5,0.6,1.0
GSBD,6,18,4,21,7,28,0.25,0.0556
BKKT,2,3,10,5,10,15,0.6667,0.3333
MDCX,1,1,3,2,3,5,0.6,1.0
SBLK,2,2,6,4,6,10,0.6,0.5
ZETA,2,1,9,3,9,12,0.75,1.0
BFAM,2,0,1,0,3,3,1.0,1.0
MRNA,8,5,12,11,14,25,0.56,0.2
ANY,1,0,4,1,4,5,0.8,1.0
BTBT,1,0,4,0,5,5,1.0,1.0
GLNG,0,2,3,4,1,5,0.2,0.5
J,0,2,3,3,2,5,0.4,0.5
JMSB,2,1,2,2,3,5,0.6,1.0
ACM,0,2,3,2,3,5,0.6,0.5
WLK,0,0,5,3,2,5,0.4,1.0
ORGN,2,1,1,1,3,4,0.75,1.0
AGEN,3,1,1,1,4,5,0.8,1.0
KRON,5,1,3,4,5,9,0.5556,1.0
DDS,1,1,3,2,3,5,0.6,1.0
BN,0,0,5,0,5,5,1.0,1.0
IBTA,1,0,3,0,4,4,1.0,1.0
POST,0,1,4,2,3,5,0.6,1.0
NICE,1,1,8,1,9,10,0.9,1.0
SBH,1,4,4,5,4,9,0.4444,0.25
GLOB,1,0,3,0,4,4,1.0,1.0
DOCS,0,0,3,0,3,3,1.0,1.0
AAP,7,1,1,1,8,9,0.8889,1.0
BE,1,0,8,2,7,9,0.7778,1.0
SYM,1,2,1,3,1,4,0.25,0.5
SRTS,0,1,4,1,4,5,0.8,1.0
AEYE,2,0,3,1,4,5,0.8,1.0
MPTI,3,0,3,1,5,6,0.8333,1.0
FLYW,2,1,1,3,1,4,0.25,1.0
TLSI,3,2,0,2,3,5,0.6,0.5
ASA,1,2,2,4,1,5,0.2,0.5
STTK,5,0,0,1,4,5,0.8,1.0
IDN,2,0,2,0,4,4,1.0,1.0
ALTG,6,3,1,5,5,10,0.5,0.3333
CSCO,2,2,5,4,5,9,0.5556,0.5
CIX,4,1,0,1,4,5,0.8,1.0
HI,4,0,1,0,5,5,1.0,1.0
FOUR,1,0,6,2,5,7,0.7143,1.0
CYBR,1,1,6,1,7,8,0.875,1.0
SONO,2,0,1,0,3,3,1.0,1.0
CTRA,0,0,4,0,4,4,1.0,1.0
BLNK,3,1,0,1,3,4,0.75,1.0
ROIV,2,1,2,1,4,5,0.8,1.0
JD,3,2,5,4,6,10,0.6,0.5
REGN,2,1,2,3,2,5,0.4,1.0
XOS,2,1,2,2,3,5,0.6,1.0
BRBR,1,2,2,3,2,5,0.4,0.5
SPB,3,1,1,2,3,5,0.6,1.0
VERO,4,1,0,1,4,5,0.8,1.0
PANL,1,0,4,2,3,5,0.6,1.0
MRSN,2,0,3,2,3,5,0.6,1.0
GILD,1,0,4,2,3,5,0.6,1.0
ICUI,0,0,5,1,4,5,0.8,1.0
TGI,1,1,2,1,3,4,0.75,1.0
ALIT,2,1,2,2,3,5,0.6,1.0
MOS,2,0,3,1,4,5,0.8,1.0
AAON,1,2,2,4,1,5,0.2,0.5
HD,3,2,8,4,9,13,0.6923,0.5
AXSM,2,0,3,1,4,5,0.8,1.0
ZI,3,0,1,1,3,4,0.75,1.0
CAVA,0,0,19,0,19,19,1.0,1.0
MARA,3,0,1,0,4,4,1.0,1.0
NSSC,3,2,10,5,10,15,0.6667,0.5
TEO,1,1,2,2,2,4,0.5,1.0
GRPN,1,2,2,2,3,5,0.6,0.5
GPS,0,1,7,4,4,8,0.5,1.0
AGO,1,2,2,3,2,5,0.4,0.5
IAC,2,2,6,4,6,10,0.6,0.5
MNDY,1,1,3,3,2,5,0.4,1.0
LYV,3,1,5,4,5,9,0.5556,1.0
PGNY,3,3,4,3,7,10,0.7,0.3333
ARMK,2,3,0,3,2,5,0.4,0.3333
SHLS,2,0,1,1,2,3,0.6667,1.0
CMTG,2,3,3,4,4,8,0.5,0.3333
BR,0,2,3,4,1,5,0.2,0.5
LSCC,2,1,2,1,4,5,0.8,1.0
MIRM,1,1,3,2,3,5,0.6,1.0
TSVT,2,2,0,2,2,4,0.5,0.5
NRSNW,6,0,0,2,4,6,0.6667,1.0
LAZR,1,0,3,0,4,4,1.0,1.0
CMG,3,4,3,5,5,10,0.5,0.25
WMS,1,0,1,0,2,2,1.0,1.0
FBND,2,6,0,7,1,8,0.125,0.1667
CHIE,1,7,11,12,7,19,0.3684,0.1429
JGLD,2,6,1,7,2,9,0.2222,0.1667
VNM,0,4,5,5,4,9,0.4444,0.25
MCHI,0,4,5,4,5,9,0.5556,0.25
EC,1,0,4,2,3,5,0.6,1.0
ME,2,1,2,2,3,5,0.6,1.0
PPL,0,2,3,3,2,5,0.4,0.5
ALC,0,1,3,1,3,4,0.75,1.0
SVCO,1,2,2,4,1,5,0.2,0.5
LNZA,2,1,1,1,3,4,0.75,1.0
WES,1,3,1,4,1,5,0.2,0.3333
BX,0,1,7,1,7,8,0.875,1.0
FTRE,2,1,1,2,2,4,0.5,1.0
AMCX,5,0,0,1,4,5,0.8,1.0
PARA,4,1,4,5,4,9,0.4444,1.0
DNA,2,1,2,2,3,5,0.6,1.0
AGL,3,0,0,0,3,3,1.0,1.0
VALE,1,1,1,2,1,3,0.3333,1.0
SMAR,1,0,1,1,1,2,0.5,1.0
CE,2,0,0,0,2,2,1.0,1.0
ATMU,0,1,3,1,3,4,0.75,1.0
MLNK,0,0,2,0,2,2,1.0,1.0
OMCL,2,1,0,1,2,3,0.6667,1.0
AMH,0,2,2,4,0,4,0.0,0.5
TM,1,4,8,6,7,13,0.5385,0.25
FLEE,4,7,4,8,7,15,0.4667,0.1429
SHIBUSD,0,5,5,5,5,10,0.5,0.2
IQM,0,2,9,6,5,11,0.4545,0.5
RKLB,3,2,10,3,12,15,0.8,0.5
RDNT,1,2,1,4,0,4,0.0,0.5
EXFY,1,1,2,2,2,4,0.5,1.0
DH,1,0,4,2,3,5,0.6,1.0
TSBX,3,1,0,1,3,4,0.75,1.0
BHVN,1,1,3,1,4,5,0.8,1.0
STRO,0,1,3,3,1,4,0.25,1.0
III,1,1,2,2,2,4,0.5,1.0
LWAY,2,1,7,2,8,10,0.8,1.0
IGMS,3,1,0,1,3,4,0.75,1.0
NUTX,2,0,2,0,4,4,1.0,1.0
SBT,2,2,1,3,2,5,0.4,0.5
OPAL,1,1,3,2,3,5,0.6,1.0
DKNG,7,2,1,3,7,10,0.7,0.5
GCT,0,1,4,1,4,5,0.8,1.0
DRH,1,2,2,3,2,5,0.4,0.5
ZD,0,0,5,1,4,5,0.8,1.0
MTUS,3,0,2,2,3,5,0.6,1.0
VCTR,0,2,3,4,1,5,0.2,0.5
TTD,3,4,1,4,4,8,0.5,0.25
MTD,0,1,4,1,4,5,0.8,1.0
ALKT,1,1,3,4,1,5,0.2,1.0
PEB,2,1,7,2,8,10,0.8,1.0
CIVI,1,2,2,3,2,5,0.4,0.5
KOP,2,0,3,1,4,5,0.8,1.0
YMAB,4,0,1,2,3,5,0.6,1.0
ABNB,5,2,4,4,7,11,0.6364,0.5
CGC,3,0,2,1,4,5,0.8,1.0
LCID,0,0,9,2,7,9,0.7778,1.0
XERS,0,2,3,2,3,5,0.6,0.5
WPM,0,2,3,2,3,5,0.6,0.5
RLJ,0,1,4,1,4,5,0.8,1.0
PAHC,1,1,3,2,3,5,0.6,1.0
RCMT,1,1,3,3,2,5,0.4,1.0
ARRY,4,0,0,1,3,4,0.75,1.0
ALNT,1,0,4,2,3,5,0.6,1.0
MKSI,0,0,5,2,3,5,0.6,1.0
GRMN,3,0,9,0,12,12,1.0,1.0
MTSI,1,0,4,1,4,5,0.8,1.0
MWFLX,0,2,5,2,5,7,0.7143,0.5
TPVG,2,1,1,2,2,4,0.5,1.0
DCO,0,2,3,3,2,5,0.4,0.5
FSLY,0,1,3,1,3,4,0.75,1.0
ARM,2,0,2,1,3,4,0.75,1.0
COTY,3,0,1,0,4,4,1.0,1.0
TRIP,2,0,1,2,1,3,0.3333,1.0
Z,0,0,3,1,2,3,0.6667,1.0
XNCR,2,1,2,1,4,5,0.8,1.0
SITC,1,2,2,2,3,5,0.6,0.5
WTI,2,2,1,3,2,5,0.4,0.5
STRL,0,2,3,3,2,5,0.4,0.5
HUBS,0,0,4,2,2,4,0.5,1.0
ASH,0,2,3,4,1,5,0.2,0.5
CLNE,0,0,5,2,3,5,0.6,1.0
CLVT,5,0,0,0,5,5,1.0,1.0
JAZZ,1,1,3,2,3,5,0.6,1.0
ACGL,1,0,3,1,3,4,0.75,1.0
ARIS,0,1,4,3,2,5,0.4,1.0
STWD,1,1,3,1,4,5,0.8,1.0
PINS,2,2,29,10,23,33,0.697,0.5
CELH,1,0,4,0,5,5,1.0,1.0
MCHP,5,0,2,1,6,7,0.8571,1.0
TME,0,0,3,0,3,3,1.0,1.0
IFF,1,1,6,2,6,8,0.75,1.0
DVN,3,0,9,2,10,12,0.8333,1.0
LUMN,1,0,7,0,8,8,1.0,1.0
NTB,1,1,3,1,4,5,0.8,1.0
IONS,0,1,4,1,4,5,0.8,1.0
PAYO,0,2,3,3,2,5,0.4,0.5
SHC,2,1,1,2,2,4,0.5,1.0
CRUS,1,0,3,0,4,4,1.0,1.0
APO,0,0,10,1,9,10,0.9,1.0
NYT,2,0,7,1,8,9,0.8889,1.0
FOXA,1,1,13,4,11,15,0.7333,1.0
INTA,2,1,2,1,4,5,0.8,1.0
MODG,1,1,3,1,4,5,0.8,1.0
PTLO,4,2,2,2,6,8,0.75,0.5
DEA,1,1,3,2,3,5,0.6,1.0
GT,1,0,3,1,3,4,0.75,1.0
EGHT,1,0,2,0,3,3,1.0,1.0
ILMN,3,0,2,0,5,5,1.0,1.0
MQ,2,0,1,0,3,3,1.0,1.0
CMS,0,0,2,0,2,2,1.0,1.0
HOLX,0,0,4,1,3,4,0.75,1.0
BCC,2,2,1,3,2,5,0.4,0.5
HHH,1,0,4,2,3,5,0.6,1.0
GOOD,2,1,2,2,3,5,0.6,1.0
FANG,2,4,1,6,1,7,0.1429,0.25
GLT,1,2,1,3,1,4,0.25,0.5
MED,1,0,3,2,2,4,0.5,1.0
CNTY,3,0,2,1,4,5,0.8,1.0
EXAS,0,0,5,1,4,5,0.8,1.0
ASM,1,1,3,2,3,5,0.6,1.0
RVTY,2,3,0,3,2,5,0.4,0.3333
PEG,2,0,4,1,5,6,0.8333,1.0
MAR,2,1,4,4,3,7,0.4286,1.0
L,2,0,2,0,4,4,1.0,1.0
BRK-B,3,3,9,6,9,15,0.6,0.3333
CEG,1,0,4,0,5,5,1.0,1.0
BAM,0,0,5,1,4,5,0.8,1.0
EXPD,2,1,4,2,5,7,0.7143,1.0
DD,0,0,5,1,4,5,0.8,1.0
CMRE,2,2,6,3,7,10,0.7,0.5
CHD,0,1,4,1,4,5,0.8,1.0
BEN,2,4,3,6,3,9,0.3333,0.25
SOHO,0,1,3,2,2,4,0.5,1.0
DBRG,1,2,2,3,2,5,0.4,0.5
NVT,1,3,1,3,2,5,0.4,0.3333
D,2,3,7,7,5,12,0.4167,0.3333
CVX,0,3,6,4,5,9,0.5556,0.3333
BC,7,2,1,4,6,10,0.6,0.5
LYB,2,0,3,1,4,5,0.8,1.0
W,4,0,1,2,3,5,0.6,1.0
SPG,1,0,2,0,3,3,1.0,1.0
XOM,0,2,3,3,2,5,0.4,0.5
TZUP,0,0,4,0,4,4,1.0,1.0
DSGR,1,1,3,2,3,5,0.6,1.0
H,0,1,4,1,4,5,0.8,1.0
SABR,3,1,1,1,4,5,0.8,1.0
SRI,2,1,2,1,4,5,0.8,1.0
SM,3,1,0,3,1,4,0.25,1.0
LIN,0,1,4,1,4,5,0.8,1.0
NOK,0,4,5,7,2,9,0.2222,0.25
HII,5,3,2,4,6,10,0.6,0.3333
WEAV,0,1,4,1,4,5,0.8,1.0
SFM,0,2,2,2,2,4,0.5,0.5
SO,0,0,4,1,3,4,0.75,1.0
EBAY,2,0,2,0,4,4,1.0,1.0
UBER,5,10,15,12,18,30,0.6,0.1
RBLX,6,1,6,3,10,13,0.7692,1.0
ICE,0,2,3,2,3,5,0.6,0.5
GWW,0,2,3,2,3,5,0.6,0.5
ALTR,2,0,2,1,3,4,0.75,1.0
ALE,2,2,1,4,1,5,0.2,0.5
BG,3,1,3,1,6,7,0.8571,1.0
NVCR,2,0,3,0,5,5,1.0,1.0
ORN,2,0,3,0,5,5,1.0,1.0
MKL,1,2,2,2,3,5,0.6,0.5
MGPI,5,0,0,1,4,5,0.8,1.0
PRU,1,1,3,2,3,5,0.6,1.0
SWK,3,1,1,1,4,5,0.8,1.0
TT,0,1,4,2,3,5,0.6,1.0
EXC,0,1,4,2,3,5,0.6,1.0
ARCC,2,3,0,3,2,5,0.4,0.3333
MBLY,1,3,0,3,1,4,0.25,0.3333
GEHC,0,0,5,1,4,5,0.8,1.0
NRDS,0,0,4,0,4,4,1.0,1.0
ABBV,0,0,4,0,4,4,1.0,1.0
ITW,0,0,6,0,6,6,1.0,1.0
KHC,2,0,1,1,2,3,0.6667,1.0
WM,1,4,4,5,4,9,0.4444,0.25
XPO,2,0,6,2,6,8,0.75,1.0
GIC,3,1,1,2,3,5,0.6,1.0
TEL,0,1,3,1,3,4,0.75,1.0
GSK,1,1,2,1,3,4,0.75,1.0
HCRB,0,1,5,2,4,6,0.6667,1.0
PM,0,1,19,1,19,20,0.95,1.0
ESAB,0,1,4,1,4,5,0.8,1.0
MERC,3,0,2,2,3,5,0.6,1.0
SKWD,0,0,5,2,3,5,0.6,1.0
AMT,3,1,4,3,5,8,0.625,1.0
MSCI,2,1,7,3,7,10,0.7,1.0
CROX,2,0,22,2,22,24,0.9167,1.0
SYY,1,1,3,2,3,5,0.6,1.0
CPAY,1,0,3,0,4,4,1.0,1.0
CPRT,1,1,12,5,9,14,0.6429,1.0
SC,0,2,7,4,5,9,0.5556,0.5
LTC,0,1,4,1,4,5,0.8,1.0
BRX,1,3,1,3,2,5,0.4,0.3333
CF,2,0,3,3,2,5,0.4,1.0
EHC,0,0,5,0,5,5,1.0,1.0
AMGN,1,2,2,3,2,5,0.4,0.5
BRO,0,0,5,1,4,5,0.8,1.0
WELL,0,4,6,6,4,10,0.4,0.25
SBAC,2,1,7,5,5,10,0.5,1.0
ON,1,2,2,2,3,5,0.6,0.5
BOW,1,1,3,1,4,5,0.8,1.0
ENSG,1,0,8,2,7,9,0.7778,1.0
PHG,5,0,0,0,5,5,1.0,1.0
BOH,0,0,4,0,4,4,1.0,1.0
CNP,3,1,1,2,3,5,0.6,1.0
SKY,0,1,4,1,4,5,0.8,1.0
BOOT,0,0,5,0,5,5,1.0,1.0
FLJP,13,6,0,7,12,19,0.6316,0.1667
QQQN,1,0,6,3,4,7,0.5714,1.0
EPP,2,4,1,5,2,7,0.2857,0.25
DIA,0,0,9,2,7,9,0.7778,1.0
EA,0,2,3,4,1,5,0.2,0.5
CAKE,1,2,7,7,3,10,0.3,0.5
AKR,1,1,3,3,2,5,0.4,1.0
GNTX,0,0,5,1,4,5,0.8,1.0
CVI,3,1,1,2,3,5,0.6,1.0
SNYR,1,1,2,2,2,4,0.5,1.0
ASGN,1,1,7,3,6,9,0.6667,1.0
CNC,1,0,4,2,3,5,0.6,1.0
SKX,0,0,3,0,3,3,1.0,1.0
COUR,5,0,4,2,7,9,0.7778,1.0
DXCM,2,0,1,1,2,3,0.6667,1.0
SAM,2,0,2,0,4,4,1.0,1.0
RMD,0,0,7,0,7,7,1.0,1.0
BNDW,0,4,3,6,1,7,0.1429,0.25
CPRI,1,3,2,4,2,6,0.3333,0.3333
RWR,0,5,7,6,6,12,0.5,0.2
ZYXI,1,2,2,2,3,5,0.6,0.5
TXRH,0,1,4,2,3,5,0.6,1.0
POOL,3,1,4,3,5,8,0.625,1.0
LHX,1,1,8,1,9,10,0.9,1.0
KKR,0,1,4,1,4,5,0.8,1.0
RCUS,1,1,2,1,3,4,0.75,1.0
IBM,11,4,12,8,19,27,0.7037,0.25
HAS,3,0,2,0,5,5,1.0,1.0
POR,0,0,5,0,5,5,1.0,1.0
AON,0,1,4,1,4,5,0.8,1.0
ALLE,1,1,3,3,2,5,0.4,1.0
LRCX,0,0,11,1,10,11,0.9091,1.0
SPR,3,0,1,1,3,4,0.75,1.0
LVS,4,0,0,0,4,4,1.0,1.0
TRU,0,2,3,2,3,5,0.6,0.5
AAL,2,0,3,1,4,5,0.8,1.0
UL,0,2,9,4,7,11,0.6364,0.5
DSY.PA,4,2,1,4,3,7,0.4286,0.5
URI,0,2,3,4,1,5,0.2,0.5
ODFL,2,0,3,0,5,5,1.0,1.0
LII,0,0,5,1,4,5,0.8,1.0
SYBT,1,1,3,2,3,5,0.6,1.0
TNL,0,1,9,2,8,10,0.8,1.0
HAFC,0,2,3,3,2,5,0.4,0.5
CME,0,0,5,0,5,5,1.0,1.0
TMO,3,0,2,3,2,5,0.4,1.0
EWBC,1,2,2,3,2,5,0.4,0.5
TFII,2,0,3,1,4,5,0.8,1.0
"QCOM, NASDAQ",5,1,2,3,5,8,0.625,1.0
ALGN,2,0,3,1,4,5,0.8,1.0
WEX,1,2,2,4,1,5,0.2,0.5
NBR,4,0,1,1,4,5,0.8,1.0
NSC,3,5,6,7,7,14,0.5,0.2
KTOS,0,1,3,1,3,4,0.75,1.0
PHM,2,0,2,0,4,4,1.0,1.0
HSTM,0,1,4,2,3,5,0.6,1.0
AUB,0,2,3,3,2,5,0.4,0.5
CLB,1,0,4,0,5,5,1.0,1.0
RAND.AS,0,1,7,3,5,8,0.625,1.0
IHG,0,1,9,2,8,10,0.8,1.0
LOGI,0,2,8,2,8,10,0.8,0.5
MCO,0,3,8,3,8,11,0.7273,0.3333
HDB,0,3,2,3,2,5,0.4,0.3333
ACWF,2,3,5,7,3,10,0.3,0.3333
SASR,2,1,1,1,3,4,0.75,1.0
RACE,1,1,3,1,4,5,0.8,1.0
GNRC,1,0,3,0,4,4,1.0,1.0
CVS,1,1,8,1,9,10,0.9,1.0
HTZ,3,0,1,0,4,4,1.0,1.0
CVRX,1,1,2,1,3,4,0.75,1.0
STLD,5,2,3,3,7,10,0.7,0.5
ALV,3,1,0,2,2,4,0.5,1.0
UPS,6,3,4,3,10,13,0.7692,0.3333
PAC,0,0,4,1,3,4,0.75,1.0
GOOS,4,0,1,1,4,5,0.8,1.0
CADE,0,2,3,2,3,5,0.6,0.5
BMI,1,0,3,0,4,4,1.0,1.0
MMC,0,1,4,1,4,5,0.8,1.0
AVY,0,2,5,2,5,7,0.7143,0.5
SE,0,0,4,0,4,4,1.0,1.0
ASML,11,5,0,6,10,16,0.625,0.2
MC.PA,10,3,3,7,9,16,0.5625,0.3333
APAM,2,3,6,6,5,11,0.4545,0.3333
ASML.AS,6,4,1,6,5,11,0.4545,0.25
IRDM,0,4,1,4,1,5,0.2,0.25
EFX,0,1,4,1,4,5,0.8,1.0
HTHT,0,0,5,0,5,5,1.0,1.0
TWN,0,3,7,3,7,10,0.7,0.3333
BND,2,5,3,7,3,10,0.3,0.2
CAT,3,0,0,0,3,3,1.0,1.0
VFC,0,0,3,0,3,3,1.0,1.0
FROG,0,1,4,1,4,5,0.8,1.0
YELP,1,0,3,1,3,4,0.75,1.0
EEM,1,5,3,7,2,9,0.2222,0.2
APPF,0,0,5,2,3,5,0.6,1.0
ALTM,2,0,3,2,3,5,0.6,1.0
ESE,1,0,4,1,4,5,0.8,1.0
TTM,0,6,3,8,1,9,0.1111,0.1667
TLRY,3,3,4,5,5,10,0.5,0.3333
CELZ,2,0,2,0,4,4,1.0,1.0
LPLA,0,0,2,0,2,2,1.0,1.0
WERN,3,0,0,0,3,3,1.0,1.0
CIT,2,2,3,5,2,7,0.2857,0.5
SARO,1,0,4,0,5,5,1.0,1.0
KLC,0,1,3,1,3,4,0.75,1.0
APLD,2,1,2,1,4,5,0.8,1.0
BYRN,2,0,3,1,4,5,0.8,1.0
EMN,0,0,5,0,5,5,1.0,1.0
SOC,2,0,1,0,3,3,1.0,1.0
CMDY,7,14,15,24,12,36,0.3333,0.0714
NAPA,1,0,6,1,6,7,0.8571,1.0
PNR,0,1,4,1,4,5,0.8,1.0
VSTO,0,3,6,6,3,9,0.3333,0.3333
EWW,3,6,6,7,8,15,0.5333,0.1667
ADAUSD,2,6,0,6,2,8,0.25,0.1667
SDY,0,12,3,15,0,15,0.0,0.0833
DIVO,0,7,5,10,2,12,0.1667,0.1429
LEVI,5,1,1,2,5,7,0.7143,1.0
HSY,2,0,3,0,5,5,1.0,1.0
BOEI.BR,18,13,3,15,19,34,0.5588,0.0769
EIDO,1,2,0,2,1,3,0.3333,0.5
MKC,0,2,1,2,1,3,0.3333,0.5
PTN,0,2,1,2,1,3,0.3333,0.5
GULF,2,6,4,9,3,12,0.25,0.1667
DTEC,9,9,3,14,7,21,0.3333,0.1111
EWT,6,4,5,4,11,15,0.7333,0.25
AVNW,1,1,2,3,1,4,0.25,1.0
MLSS,2,1,2,1,4,5,0.8,1.0
TRAK,0,0,5,0,5,5,1.0,1.0
GLRE,2,2,5,3,6,9,0.6667,0.5
BMR,2,0,7,3,6,9,0.6667,1.0
SPIR,3,1,0,1,3,4,0.75,1.0
INDP,1,2,2,2,3,5,0.6,0.5
MNKD,2,1,7,2,8,10,0.8,1.0
UNM,0,0,4,0,4,4,1.0,1.0
PI,0,0,3,0,3,3,1.0,1.0
AN,0,0,3,0,3,3,1.0,1.0
JPXN,7,3,0,3,7,10,0.7,0.3333
ORAN,3,4,1,6,2,8,0.25,0.25
VEQT.TO,3,5,0,6,2,8,0.25,0.2
SSLY,0,1,5,2,4,6,0.6667,1.0
DRS,1,1,3,1,4,5,0.8,1.0
VAL,0,1,2,2,1,3,0.3333,1.0
MTN,1,2,2,4,1,5,0.2,0.5
JNPR,0,2,3,4,1,5,0.2,0.5
IDYA,0,0,3,1,2,3,0.6667,1.0
BWAY,1,1,3,3,2,5,0.4,1.0
THO,2,1,2,3,2,5,0.4,1.0
BATL,0,1,4,3,2,5,0.4,1.0
VKTX,2,8,3,9,4,13,0.3077,0.125
CHIL,4,2,0,2,4,6,0.6667,0.5
IMRX,2,0,3,2,3,5,0.6,1.0
BEAM,2,1,2,2,3,5,0.6,1.0
KAPA,1,0,4,2,3,5,0.6,1.0
OPFI,1,0,4,0,5,5,1.0,1.0
PARR,3,0,0,0,3,3,1.0,1.0
SCCO,0,1,3,2,2,4,0.5,1.0
TPB,0,1,2,1,2,3,0.6667,1.0
HGTY,1,0,3,0,4,4,1.0,1.0
CBRL,2,0,3,2,3,5,0.6,1.0
SNY,1,0,3,1,3,4,0.75,1.0
ADI,1,0,1,0,2,2,1.0,1.0
RXO,1,0,2,0,3,3,1.0,1.0
DUK,0,1,3,2,2,4,0.5,1.0
EUSA,4,3,0,5,2,7,0.2857,0.3333
EWH,0,4,5,4,5,9,0.5556,0.25
EWZ,2,6,3,7,4,11,0.3636,0.1667
ELF,2,0,1,2,1,3,0.3333,1.0
EL),1,1,1,1,2,3,0.6667,1.0
NCNA,0,1,5,1,5,6,0.8333,1.0
WPC,1,0,4,0,5,5,1.0,1.0
MAA,1,0,3,1,3,4,0.75,1.0
ASPU,0,0,5,0,5,5,1.0,1.0
EWI,0,2,6,5,3,8,0.375,0.5
TDV,0,3,2,4,1,5,0.2,0.3333
QIE.TO,2,5,3,6,4,10,0.4,0.2
CHIC,0,2,3,2,3,5,0.6,0.5
EUR.TO,2,4,0,5,1,6,0.1667,0.25
COM,2,10,0,11,1,12,0.0833,0.1
DOD,0,4,1,4,1,5,0.2,0.25
TOK,0,4,1,5,0,5,0.0,0.25
SFBC,1,2,2,4,1,5,0.2,0.5
PUBM,1,0,4,2,3,5,0.6,1.0
CELU,0,0,5,1,4,5,0.8,1.0
MPC,3,0,2,2,3,5,0.6,1.0
SRE,0,1,3,2,2,4,0.5,1.0
BORR,0,0,3,0,3,3,1.0,1.0
CAL,4,0,1,1,4,5,0.8,1.0
BIG,8,1,0,2,7,9,0.7778,1.0
U,3,0,4,2,5,7,0.7143,1.0
PLOW,1,0,4,2,3,5,0.6,1.0
RIG,2,0,1,0,3,3,1.0,1.0
TROW,1,1,2,2,2,4,0.5,1.0
DBI,4,0,1,0,5,5,1.0,1.0
APP,0,0,4,0,4,4,1.0,1.0
VOYA,0,0,5,1,4,5,0.8,1.0
AIOT,0,1,4,2,3,5,0.6,1.0
UAE,0,3,6,3,6,9,0.6667,0.3333
SMFG,0,3,6,3,6,9,0.6667,0.3333
FLTW,5,1,3,4,5,9,0.5556,1.0
SPYV,0,3,6,3,6,9,0.6667,0.3333
FOX,0,8,0,8,0,8,0.0,0.125
UPV,0,0,8,1,7,8,0.875,1.0
FINX,4,5,1,6,4,10,0.4,0.2
KBE,0,4,6,5,5,10,0.5,0.25
ATD-B.TO,1,9,6,10,6,16,0.375,0.1111
MRK,0,0,5,0,5,5,1.0,1.0
ZEPP,1,2,1,2,2,4,0.5,0.5
RBRK,1,0,3,1,3,4,0.75,1.0
BNED,0,1,4,1,4,5,0.8,1.0
SOL,0,1,4,2,3,5,0.6,1.0
TDC,0,1,4,2,3,5,0.6,1.0
SOND,0,0,5,1,4,5,0.8,1.0
SOLV,0,0,3,0,3,3,1.0,1.0
CRMT,2,0,3,2,3,5,0.6,1.0
ZENV,0,0,4,1,3,4,0.75,1.0
LQDA,2,1,2,1,4,5,0.8,1.0
SWBI,0,1,3,2,2,4,0.5,1.0
NBY,1,0,3,2,2,4,0.5,1.0
BFRI,2,1,1,1,3,4,0.75,1.0
BBCP,0,0,4,2,2,4,0.5,1.0
SGRP,0,0,5,2,3,5,0.6,1.0
LXU,1,0,1,0,2,2,1.0,1.0
VRCA,2,1,1,2,2,4,0.5,1.0
YETI,0,0,5,0,5,5,1.0,1.0
CRTO,0,0,4,1,3,4,0.75,1.0
ASND,0,0,5,2,3,5,0.6,1.0
CUBI,1,0,4,2,3,5,0.6,1.0
IDEX,3,0,2,2,3,5,0.6,1.0
DOYU,1,0,4,1,4,5,0.8,1.0
TOPS,1,1,3,3,2,5,0.4,1.0
GTHX,3,1,1,1,4,5,0.8,1.0
BFIN,1,1,3,2,3,5,0.6,1.0
SPI,0,0,5,5,0,5,0.0,1.0
BNOX,0,0,5,2,3,5,0.6,1.0
EFTR,2,1,2,2,3,5,0.6,1.0
JKS,0,1,4,2,3,5,0.6,1.0
KSS,3,1,5,5,4,9,0.4444,1.0
TIGR,0,0,5,0,5,5,1.0,1.0
GAP,1,0,3,0,4,4,1.0,1.0
AILEW,5,1,0,1,5,6,0.8333,1.0
OCEAW,0,0,6,1,5,6,0.8333,1.0
GROV,2,2,1,4,1,5,0.2,0.5
HCP,0,1,4,2,3,5,0.6,1.0
JG,1,0,4,2,3,5,0.6,1.0
PDD,5,2,1,4,4,8,0.5,0.5
MDXH,2,0,2,0,4,4,1.0,1.0
SSYS,2,0,3,3,2,5,0.4,1.0
TEM,4,0,10,4,10,14,0.7143,1.0
AMRC,0,0,2,0,2,2,1.0,1.0
AVB,0,0,2,0,2,2,1.0,1.0
REX,1,0,1,0,2,2,1.0,1.0
ESS,0,0,2,0,2,2,1.0,1.0
GFI,0,1,4,1,4,5,0.8,1.0
BILI,0,1,4,1,4,5,0.8,1.0
NTES,1,0,4,0,5,5,1.0,1.0
LANC,0,0,5,3,2,5,0.4,1.0
LB,0,0,4,1,3,4,0.75,1.0
OSIS,0,1,3,2,2,4,0.5,1.0
ZK,0,0,4,0,4,4,1.0,1.0
GDS,1,0,9,2,8,10,0.8,1.0
PTON,3,1,4,1,7,8,0.875,1.0
PAGS,0,0,5,0,5,5,1.0,1.0
KEYS,2,0,2,1,3,4,0.75,1.0
PRCT,0,0,5,0,5,5,1.0,1.0
PINC,1,0,2,1,2,3,0.6667,1.0
SG,0,1,3,1,3,4,0.75,1.0
EL,2,0,2,1,3,4,0.75,1.0
SHAK,1,0,1,0,2,2,1.0,1.0
MELI,0,0,5,0,5,5,1.0,1.0
ASTS,4,0,1,1,4,5,0.8,1.0
LOT,0,0,4,1,3,4,0.75,1.0
MRVI,0,0,4,0,4,4,1.0,1.0
ASPN,0,0,5,1,4,5,0.8,1.0
RILY,4,0,1,1,4,5,0.8,1.0
FLO,1,0,2,0,3,3,1.0,1.0
,5,20,8,24,9,33,0.2727,0.05
