ticker,negative,neutral,positive,fact,opinion,volume,conviction,extremity
CSX,8,2,5,4,11,15,0.7333,0.5
ISRG,3,0,6,0,9,9,1.0,1.0
TXN,12,3,4,5,14,19,0.7368,0.3333
APD,0,1,7,1,7,8,0.875,1.0
AAPL,54,64,88,102,104,206,0.5049,0.0156
DOCN,2,0,6,1,7,8,0.875,1.0
GBCI,0,1,3,2,2,4,0.5,1.0
WRB,1,4,4,7,2,9,0.2222,0.25
OCFC,0,2,1,2,1,3,0.3333,0.5
SMCI,2,13,26,23,18,41,0.439,0.0769
VG,0,1,3,2,2,4,0.5,1.0
SOFI,3,2,4,5,4,9,0.4444,0.5
BFST,0,1,4,2,3,5,0.6,1.0
NCLH,1,3,4,3,5,8,0.625,0.3333
CNX,2,2,0,2,2,4,0.5,0.5
NTRS,0,2,8,3,7,10,0.7,0.5
OXY,6,1,1,1,7,8,0.875,1.0
PLD,5,5,11,8,13,21,0.619,0.2
HYMTF,3,0,2,1,4,5,0.8,1.0
FCX,5,0,4,3,6,9,0.6667,1.0
CRM,4,22,22,29,19,48,0.3958,0.0455
APLS,0,2,3,3,2,5,0.4,0.5
NEP,4,2,2,5,3,8,0.375,0.5
COF,3,5,11,9,10,19,0.5263,0.2
DWTX,0,1,5,1,5,6,0.8333,1.0
CHSN,5,1,0,1,5,6,0.8333,1.0
LYTS,1,2,2,4,1,5,0.2,0.5
HFWA,1,1,3,1,4,5,0.8,1.0
WKSP,3,0,5,0,8,8,1.0,1.0
WK,3,1,1,3,2,5,0.4,1.0
COSM,1,1,3,2,3,5,0.6,1.0
ELV,4,1,5,4,6,10,0.6,1.0
META,11,8,44,21,42,63,0.6667,0.125
FCCO,0,1,4,2,3,5,0.6,1.0
APH,0,1,9,2,8,10,0.8,1.0
AA,2,2,9,4,9,13,0.6923,0.5
DFS,2,0,8,2,8,10,0.8,1.0
KMI,4,7,13,14,10,24,0.4167,0.1429
PLTR,5,28,16,31,18,49,0.3673,0.0357
ALLY,4,2,3,3,6,9,0.6667,0.5
PII,6,1,2,2,7,9,0.7778,1.0
VEEV,2,3,10,7,8,15,0.5333,0.3333
FCNCA,3,2,3,3,5,8,0.625,0.5
TSLA,49,113,179,171,170,341,0.4985,0.0088
CACI,1,0,7,1,7,8,0.875,1.0
NFLX,7,14,71,27,65,92,0.7065,0.0714
HBT,1,0,4,1,4,5,0.8,1.0
NEE,4,1,4,2,7,9,0.7778,1.0
TXT,6,2,2,4,6,10,0.6,0.5
VZ,7,3,4,6,8,14,0.5714,0.3333
JNJ,5,6,12,8,15,23,0.6522,0.1667
AXP,2,0,17,2,17,19,0.8947,1.0
CATY,5,9,1,10,5,15,0.3333,0.1111
BKR,4,0,6,5,5,10,0.5,1.0
HXL,1,0,7,1,7,8,0.875,1.0
DIS,3,32,15,34,16,50,0.32,0.0312
LEN,8,2,3,4,9,13,0.6923,0.5
WNS,3,2,0,3,2,5,0.4,0.5
UNP,0,1,4,2,3,5,0.6,1.0
HZO,3,5,2,8,2,10,0.2,0.2
CMA,6,4,6,5,11,16,0.6875,0.25
HAL,2,2,1,2,3,5,0.6,0.5
STFS,6,0,0,0,6,6,1.0,1.0
BLBX,0,0,3,0,3,3,1.0,1.0
STX,4,5,9,7,11,18,0.6111,0.2
UAL,1,0,8,2,7,9,0.7778,1.0
CRNC,4,0,5,1,8,9,0.8889,1.0
AMZN,5,9,14,12,16,28,0.5714,0.1111
GDDFF,1,1,3,2,3,5,0.6,1.0
CNS,0,3,1,4,0,4,0.0,0.3333
BY,1,2,0,2,1,3,0.3333,0.5
EWJ,6,17,10,21,12,33,0.3636,0.0588
IXN,10,23,28,37,24,61,0.3934,0.0435
BAC,39,80,96,120,95,215,0.4419,0.0125
BTCUSD,49,185,157,246,145,391,0.3708,0.0054
GOOG,3,30,37,37,33,70,0.4714,0.0333
USDXUSD,43,53,35,82,49,131,0.374,0.0189
SPY,250,599,434,799,484,1283,0.3772,0.0017
MSFT,13,8,22,16,27,43,0.6279,0.125
ORCL,9,18,16,25,18,43,0.4186,0.0556
SNOW,3,4,15,9,13,22,0.5909,0.25
QGEN,0,2,3,3,2,5,0.4,0.5
AGYS,0,1,3,2,2,4,0.5,1.0
ABT,0,1,17,4,14,18,0.7778,1.0
SLG,2,3,5,6,4,10,0.4,0.3333
WSBC,1,2,2,2,3,5,0.6,0.5
FBK,2,1,2,2,3,5,0.6,1.0
V,1,1,20,3,19,22,0.8636,1.0
CBU,0,0,5,1,4,5,0.8,1.0
HGAS,5,3,4,4,8,12,0.6667,0.3333
GOEV,5,1,0,1,5,6,0.8333,1.0
WSM,2,2,9,2,11,13,0.8462,0.5
FSLR,10,1,8,4,15,19,0.7895,1.0
SCHW,1,2,13,4,12,16,0.75,0.5
RDDT,1,2,17,4,16,20,0.8,0.5
DHI,4,1,5,4,6,10,0.6,1.0
MMM,7,5,13,11,14,25,0.56,0.2
KEY,4,0,6,3,7,10,0.7,1.0
AEE,0,0,4,0,4,4,1.0,1.0
GOOGL,16,26,44,41,45,86,0.5233,0.0385
GM,6,5,10,7,14,21,0.6667,0.2
NRG,1,1,7,4,5,9,0.5556,1.0
CFG,1,2,10,6,7,13,0.5385,0.5
FITB,3,4,7,5,9,14,0.6429,0.25
SF,1,3,1,4,1,5,0.2,0.3333
TDY,0,3,2,4,1,5,0.2,0.3333
INDA,14,22,14,27,23,50,0.46,0.0455
GXC,41,74,36,94,57,151,0.3775,0.0135
JSTC,11,14,6,17,14,31,0.4516,0.0714
IYE,6,18,2,19,7,26,0.2692,0.0556
NVDA,39,137,109,177,108,285,0.3789,0.0073
IEV,13,22,13,31,17,48,0.3542,0.0455
ASEA,30,56,33,72,47,119,0.395,0.0179
TEMPUSD,0,7,6,9,4,13,0.3077,0.1429
TRV,1,1,12,4,10,14,0.7143,1.0
PRGS,0,1,4,2,3,5,0.6,1.0
TFC,5,2,6,5,8,13,0.6154,0.5
ONB,1,1,3,1,4,5,0.8,1.0
PPA,0,2,19,5,16,21,0.7619,0.5
XRPUSD,11,13,7,20,11,31,0.3548,0.0769
WIT,2,2,3,4,3,7,0.4286,0.5
AAAU,41,68,35,90,54,144,0.375,0.0147
TSM,3,10,42,21,34,55,0.6182,0.1
SBTCUSD,2,11,3,12,4,16,0.25,0.0909
KYN,0,5,0,5,0,5,0.0,0.2
EIS,4,4,6,6,8,14,0.5714,0.25
QEM.TO,3,5,0,6,2,8,0.25,0.2
UBS,7,44,29,51,29,80,0.3625,0.0227
GAS.TO,2,5,4,7,4,11,0.3636,0.2
ETHI.TO,1,7,3,8,3,11,0.2727,0.1429
SPYB,3,17,1,19,2,21,0.0952,0.0588
AMD,27,25,25,38,39,77,0.5065,0.04
PSJ,0,5,4,6,3,9,0.3333,0.2
VITL,1,2,6,4,5,9,0.5556,0.5
OUT,0,3,1,3,1,4,0.25,0.3333
WBS,2,1,2,2,3,5,0.6,1.0
COIN,0,0,8,3,5,8,0.625,1.0
AMAT,7,6,10,9,14,23,0.6087,0.1667
PCYO,5,2,1,2,6,8,0.75,0.5
FAST,10,2,2,6,8,14,0.5714,0.5
ADP,0,2,3,3,2,5,0.4,0.5
RHE-PA,0,1,5,1,5,6,0.8333,1.0
HBAN,0,2,8,5,5,10,0.5,0.5
SLB,8,2,14,4,20,24,0.8333,0.5
STT,3,3,13,4,15,19,0.7895,0.3333
JBHT,6,1,3,2,8,10,0.8,1.0
LLY,3,0,11,1,13,14,0.9286,1.0
CVLT,1,2,1,2,2,4,0.5,0.5
AESI,0,0,4,1,3,4,0.75,1.0
SNAP,10,6,16,7,25,32,0.7812,0.1667
RF,2,4,8,7,7,14,0.5,0.25
FHN,1,1,3,3,2,5,0.4,1.0
BOKF,0,1,4,2,3,5,0.6,1.0
INDB,1,0,4,3,2,5,0.4,1.0
OZK,1,0,4,3,2,5,0.4,1.0
JOBY,3,2,7,4,8,12,0.6667,0.5
BILL,2,2,4,4,4,8,0.5,0.5
INFY,0,1,4,2,3,5,0.6,1.0
ESTC,6,4,12,6,16,22,0.7273,0.25
IBKR,3,6,6,11,4,15,0.2667,0.1667
PNC,0,1,2,1,2,3,0.6667,1.0
MTB,0,2,13,3,12,15,0.8,0.5
NEOG,1,0,4,3,2,5,0.4,1.0
MS,8,40,30,47,31,78,0.3974,0.025
USB,2,8,8,10,8,18,0.4444,0.125
UNH,2,3,12,10,7,17,0.4118,0.3333
RLI,3,0,2,2,3,5,0.6,1.0
DJT,11,4,1,8,8,16,0.5,0.25
FC,6,3,6,5,10,15,0.6667,0.3333
HEI,4,5,9,6,12,18,0.6667,0.2
BK,1,0,4,1,4,5,0.8,1.0
SNV,0,1,9,2,8,10,0.8,1.0
HOMB,0,0,5,1,4,5,0.8,1.0
AIR,2,4,3,6,3,9,0.3333,0.25
BLK,2,7,15,9,15,24,0.625,0.1429
GS,20,57,63,82,58,140,0.4143,0.0175
HSDT,1,1,2,1,3,4,0.75,1.0
CVGW,1,1,3,3,2,5,0.4,1.0
WFC,6,8,23,15,22,37,0.5946,0.125
C,12,51,36,66,33,99,0.3333,0.0196
SPOT,3,1,12,4,12,16,0.75,1.0
EXEL,2,2,15,5,14,19,0.7368,0.5
S,3,1,12,1,15,16,0.9375,1.0
CHNA,8,8,2,11,7,18,0.3889,0.125
NOKIA.PA,0,5,3,5,3,8,0.375,0.2
VWA.BR,9,12,9,14,16,30,0.5333,0.0833
PFE,9,8,6,11,12,23,0.5217,0.125
JPN,3,15,4,17,5,22,0.2273,0.0667
SGOL,3,7,2,9,3,12,0.25,0.1429
ROKU,4,3,2,3,6,9,0.6667,0.3333
SOTK,1,1,3,2,3,5,0.6,1.0
HCAT,0,1,4,1,4,5,0.8,1.0
MA,1,2,6,6,3,9,0.3333,0.5
AGX,0,1,4,3,2,5,0.4,1.0
JPM,8,27,32,35,32,67,0.4776,0.037
ACCD,3,2,4,5,4,9,0.4444,0.5
DASH,0,0,3,0,3,3,1.0,1.0
ENPH,7,0,0,3,4,7,0.5714,1.0
SEMR,1,0,6,1,6,7,0.8571,1.0
RUM,2,0,7,1,8,9,0.8889,1.0
WDFC,1,1,3,2,3,5,0.6,1.0
ISRA,0,5,8,6,7,13,0.5385,0.2
DRIV,1,5,1,5,2,7,0.2857,0.2
SPGM,14,17,12,27,16,43,0.3721,0.0588
ACES,1,8,6,11,4,15,0.2667,0.125
QUS.TO,2,6,3,7,4,11,0.3636,0.1667
BP,7,1,3,3,8,11,0.7273,1.0
DAL,8,4,6,5,13,18,0.7222,0.25
PENG,2,1,2,1,4,5,0.8,1.0
IRTC,0,0,5,2,3,5,0.6,1.0
HON,4,3,10,5,12,17,0.7059,0.3333
SNPS,4,0,5,0,9,9,1.0,1.0
KLAC,2,0,8,1,9,10,0.9,1.0
ONTO,0,0,4,0,4,4,1.0,1.0
LZ,1,0,3,0,4,4,1.0,1.0
CART,3,0,20,6,17,23,0.7391,1.0
PYPL,8,5,17,9,21,30,0.7,0.2
PSX,3,0,6,1,8,9,0.8889,1.0
BRKR,3,3,4,3,7,10,0.7,0.3333
BUD,2,1,2,1,4,5,0.8,1.0
HUC.TO,40,42,24,57,49,106,0.4623,0.0238
AIA,21,41,25,54,33,87,0.3793,0.0244
BMRPF,1,0,4,2,3,5,0.6,1.0
MVST,2,1,2,2,3,5,0.6,1.0
ZYBT,0,0,4,1,3,4,0.75,1.0
SNX,3,0,2,1,4,5,0.8,1.0
NKE,10,4,13,6,21,27,0.7778,0.25
LULU,2,1,8,5,6,11,0.5455,1.0
VRNT,2,3,8,6,7,13,0.5385,0.3333
MCY,4,0,1,1,4,5,0.8,1.0
JSAIY,1,1,3,2,3,5,0.6,1.0
GH,0,0,4,0,4,4,1.0,1.0
XTIA,0,1,3,1,3,4,0.75,1.0
WBA,10,1,3,3,11,14,0.7857,1.0
STZ,1,2,2,3,2,5,0.4,0.5
GORO,2,0,2,2,2,4,0.5,1.0
TSCDY,1,1,3,2,3,5,0.6,1.0
DECK,0,0,8,1,7,8,0.875,1.0
GPN,3,0,1,0,4,4,1.0,1.0
CBOE,1,1,13,3,12,15,0.8,1.0
HLIT,2,0,2,0,4,4,1.0,1.0
CHKP,0,0,3,1,2,3,0.6667,1.0
MSM,1,1,3,1,4,5,0.8,1.0
BCS,13,31,26,42,28,70,0.4,0.0323
HSBC,8,26,43,38,39,77,0.5065,0.0385
ANGO,1,1,2,2,2,4,0.5,1.0
UNF,1,1,3,1,4,5,0.8,1.0
AMBA,2,2,6,6,4,10,0.4,0.5
HELE,4,4,1,4,5,9,0.5556,0.25
LFCR,6,2,6,8,6,14,0.4286,0.5
ACI,4,8,6,12,6,18,0.3333,0.125
KBH,1,7,2,8,2,10,0.2,0.1429
RCEL,3,1,4,1,7,8,0.875,1.0
APOG,3,2,4,2,7,9,0.7778,0.5
ALK,0,3,10,5,8,13,0.6154,0.3333
YUM,1,0,4,2,3,5,0.6,1.0
AYI,1,5,4,7,3,10,0.3,0.2
LUV,2,0,8,2,8,10,0.8,1.0
KRUS,0,1,4,4,1,5,0.2,1.0
KO,1,0,7,2,6,8,0.75,1.0
TWLO,0,0,4,0,4,4,1.0,1.0
SEDG,11,1,0,4,8,12,0.6667,1.0
NDAQ,0,0,3,0,3,3,1.0,1.0
IYY,62,85,42,120,69,189,0.3651,0.0118
EEMA,30,26,17,35,38,73,0.5205,0.0385
BFOCX,1,4,1,5,1,6,0.1667,0.25
GETY,0,6,1,7,0,7,0.0,0.1667
ETHUSD,1,4,3,4,4,8,0.5,0.25
HMNY,5,6,0,8,3,11,0.2727,0.1667
AEHR,1,2,2,4,1,5,0.2,0.5
SUM,0,2,3,4,1,5,0.2,0.5
AZZ,1,1,8,5,5,10,0.5,1.0
CAMT,1,1,1,2,1,3,0.3333,1.0
RELL,4,0,1,0,5,5,1.0,1.0
PYCR,3,0,1,1,3,4,0.75,1.0
CMC,3,3,4,3,7,10,0.7,0.3333
JEF,3,3,3,5,4,9,0.4444,0.3333
DHAI,6,0,0,1,5,6,0.8333,1.0
DATSW,0,1,4,1,4,5,0.8,1.0
AXON,3,3,10,5,11,16,0.6875,0.3333
LH,0,0,4,0,4,4,1.0,1.0
ZION,0,0,3,0,3,3,1.0,1.0
HIMS,0,1,3,2,2,4,0.5,1.0
RPM,0,2,13,6,9,15,0.6,0.5
LNN,0,2,3,3,2,5,0.4,0.5
CHWY,2,3,11,5,11,16,0.6875,0.3333
THNQ,7,13,6,18,8,26,0.3077,0.0769
CSML,5,9,4,15,3,18,0.1667,0.1111
PTEN,0,1,4,1,4,5,0.8,1.0
ADDYY,2,0,3,3,2,5,0.4,1.0
AEIS,0,0,3,0,3,3,1.0,1.0
TSCO,0,0,7,1,6,7,0.8571,1.0
RJF,0,0,4,0,4,4,1.0,1.0
PANW,4,2,7,5,8,13,0.6154,0.5
LYFT,0,0,7,0,7,7,1.0,1.0
SMTC,0,1,12,4,9,13,0.6923,1.0
NVO,1,0,6,1,6,7,0.8571,1.0
PAYX,2,0,3,2,3,5,0.6,1.0
NCNO,3,1,1,1,4,5,0.8,1.0
LFVN,0,1,3,2,2,4,0.5,1.0
CVNA,1,4,3,5,3,8,0.375,0.25
FCPI,8,10,3,14,7,21,0.3333,0.1
EPV,1,4,3,6,2,8,0.25,0.25
ITOT,26,33,17,46,30,76,0.3947,0.0303
HUG.TO,15,27,18,37,23,60,0.3833,0.037
EWA,7,17,10,20,14,34,0.4118,0.0588
IDAI,1,0,3,2,2,4,0.5,1.0
BBAI,8,4,6,6,12,18,0.6667,0.25
RIVN,4,0,5,0,9,9,1.0,1.0
PGPHF,0,2,1,2,1,3,0.3333,0.5
X,2,1,2,1,4,5,0.8,1.0
LC,1,0,2,0,3,3,1.0,1.0
NET,0,1,5,1,5,6,0.8333,1.0
NOW,0,1,9,1,9,10,0.9,1.0
ETN,0,0,4,0,4,4,1.0,1.0
PGRE,0,1,7,3,5,8,0.625,1.0
MTAUSD,0,1,4,3,2,5,0.4,1.0
BYD,0,4,7,5,6,11,0.5455,0.25
PTEU,5,4,1,4,6,10,0.6,0.25
VLXUSD,0,4,1,4,1,5,0.2,0.25
GBX,1,4,5,7,3,10,0.3,0.25
CPNG,0,1,4,1,4,5,0.8,1.0
BXP,1,3,0,3,1,4,0.25,0.3333
AISP,2,2,0,3,1,4,0.25,0.5
DPZ,1,1,6,3,5,8,0.625,1.0
DEI,1,1,2,2,2,4,0.5,1.0
SHW,10,0,2,3,9,12,0.75,1.0
EVRG,0,0,3,0,3,3,1.0,1.0
ROK,0,0,4,0,4,4,1.0,1.0
ALAB,1,0,3,1,3,4,0.75,1.0
SGMO,1,2,0,2,1,3,0.3333,0.5
RTX,1,0,4,1,4,5,0.8,1.0
VICI,0,1,4,1,4,5,0.8,1.0
LMT,5,3,5,6,7,13,0.5385,0.3333
ESGU,2,3,1,3,3,6,0.5,0.3333
ESGV,3,5,4,11,1,12,0.0833,0.2
BABA,10,26,30,41,25,66,0.3788,0.0385
GKOS,0,0,4,0,4,4,1.0,1.0
HOG,3,1,0,2,2,4,0.5,1.0
PNFP,0,0,4,0,4,4,1.0,1.0
SEAT,1,0,3,2,2,4,0.5,1.0
GPMT,1,0,3,1,3,4,0.75,1.0
AVO,0,1,3,2,2,4,0.5,1.0
MSGE,1,0,2,0,3,3,1.0,1.0
SDA,0,0,4,0,4,4,1.0,1.0
BA,18,18,29,31,34,65,0.5231,0.0556
LEGN,1,0,3,1,3,4,0.75,1.0
DOW,2,4,4,6,4,10,0.4,0.25
CDMO,4,0,0,3,1,4,0.25,1.0
ADBE,7,2,18,7,20,27,0.7407,0.5
CFBK,3,2,5,3,7,10,0.7,0.5
IIPR,3,1,0,1,3,4,0.75,1.0
ERNA,2,2,6,2,8,10,0.8,0.5
OXBR,1,0,4,1,4,5,0.8,1.0
SATX,1,1,3,1,4,5,0.8,1.0
GERN,3,0,2,0,5,5,1.0,1.0
BFH,2,1,2,1,4,5,0.8,1.0
WMT,8,10,27,15,30,45,0.6667,0.1
INTZ,0,1,5,2,4,6,0.6667,1.0
ONON,0,0,3,0,3,3,1.0,1.0
STNE,1,0,3,0,4,4,1.0,1.0
MASI,0,0,3,0,3,3,1.0,1.0
TBBK,0,0,3,0,3,3,1.0,1.0
MMYT,1,0,2,1,2,3,0.6667,1.0
LPTH,0,0,5,0,5,5,1.0,1.0
FDX,5,8,15,13,15,28,0.5357,0.125
ACVA,0,0,3,0,3,3,1.0,1.0
CLBT,9,5,11,5,20,25,0.8,0.2
VUZI,0,1,4,2,3,5,0.6,1.0
OKLO,3,1,1,1,4,5,0.8,1.0
CRWD,5,3,18,7,19,26,0.7308,0.3333
EAT,2,0,13,2,13,15,0.8667,1.0
EVLV,24,4,5,7,26,33,0.7879,0.25
TW,2,1,2,1,4,5,0.8,1.0
CALM,0,3,2,4,1,5,0.2,0.3333
ARDX,2,1,2,2,3,5,0.6,1.0
BAOS,0,0,5,1,4,5,0.8,1.0
DDOG,1,2,8,3,8,11,0.7273,0.5
PWR,0,0,3,0,3,3,1.0,1.0
PLYA,0,1,3,1,3,4,0.75,1.0
TOUR,3,1,1,2,3,5,0.6,1.0
LMNR,0,0,5,3,2,5,0.4,1.0
ELVA,1,1,3,2,3,5,0.6,1.0
AGR,1,1,2,3,1,4,0.25,1.0
SCHL,5,1,3,2,7,9,0.7778,1.0
AJG,1,1,2,3,1,4,0.25,1.0
UGI,0,1,8,1,8,9,0.8889,1.0
SOUN,0,0,4,0,4,4,1.0,1.0
AYTU,2,2,1,2,3,5,0.6,0.5
FINW,2,1,2,1,4,5,0.8,1.0
SQNS,4,2,3,3,6,9,0.6667,0.5
CSWI,5,2,11,6,12,18,0.6667,0.5
LW,2,3,4,5,4,9,0.4444,0.3333
LITM,1,0,3,0,4,4,1.0,1.0
CCL,1,3,6,6,4,10,0.4,0.3333
CTAS,0,1,3,1,3,4,0.75,1.0
ACN,1,3,10,5,9,14,0.6429,0.3333
KMX,1,2,2,3,2,5,0.4,0.5
WTW,1,1,2,2,2,4,0.5,1.0
BPTH,0,3,2,5,0,5,0.0,0.3333
OPHC,4,3,8,5,10,15,0.6667,0.3333
VRTX,4,0,6,1,9,10,0.9,1.0
FDS,0,0,5,2,3,5,0.6,1.0
THG,2,1,1,1,3,4,0.75,1.0
CAG,1,5,3,5,4,9,0.4444,0.2
KULR,2,0,2,1,3,4,0.75,1.0
MU,4,0,6,2,8,10,0.8,1.0
MLKN,3,0,1,0,4,4,1.0,1.0
BRLT,3,0,0,0,3,3,1.0,1.0
PATH,4,0,4,0,8,8,1.0,1.0
DRI,0,1,4,1,4,5,0.8,1.0
WOR,1,0,4,2,3,5,0.6,1.0
YCBD,2,1,1,2,2,4,0.5,1.0
WGO,1,3,1,5,0,5,0.0,0.3333
PALAF,3,1,1,2,3,5,0.6,1.0
CDNS,3,3,7,5,8,13,0.6154,0.3333
TTC,2,1,1,1,3,4,0.75,1.0
OGI,7,1,2,3,7,10,0.7,1.0
PET,2,1,0,1,2,3,0.6667,1.0
CGTX,0,1,3,3,1,4,0.25,1.0
ABM,1,0,4,1,4,5,0.8,1.0
JBL,3,2,5,4,6,10,0.6,0.5
GIS,7,6,2,7,8,15,0.5333,0.1667
BIRK,1,0,4,0,5,5,1.0,1.0
CIEN,4,2,6,2,10,12,0.8333,0.5
EXPE,0,0,6,1,5,6,0.8333,1.0
HEI-A,1,0,4,1,4,5,0.8,1.0
SBIG,1,0,4,2,3,5,0.6,1.0
PKG,0,2,12,3,11,14,0.7857,0.5
HMC,3,11,6,14,6,20,0.3,0.0909
CQQQ,2,2,7,5,6,11,0.5455,0.5
APDN,3,0,2,2,3,5,0.6,1.0
AI,1,1,8,4,6,10,0.6,1.0
ICAGY,0,1,3,1,3,4,0.75,1.0
SRAD,2,1,2,1,4,5,0.8,1.0
FTI,0,2,6,2,6,8,0.75,0.5
ZBH,1,0,3,0,4,4,1.0,1.0
ECL,0,3,5,3,5,8,0.625,0.3333
DGX,0,0,14,1,13,14,0.9286,1.0
INTC,11,7,3,9,12,21,0.5714,0.1429
COP,1,3,9,4,9,13,0.6923,0.3333
CCX.TO,3,3,0,5,1,6,0.1667,0.3333
OPOF,3,1,1,2,3,5,0.6,1.0
BB,2,3,0,4,1,5,0.2,0.3333
MITK,0,1,4,1,4,5,0.8,1.0
RICK,0,2,3,3,2,5,0.4,0.5
MAMA,2,1,2,4,1,5,0.2,1.0
RCAT,3,0,2,1,4,5,0.8,1.0
CLSD,4,2,4,2,8,10,0.8,0.5
T,7,6,10,9,14,23,0.6087,0.1667
DRCT,0,4,0,4,0,4,0.0,0.25
F,3,0,1,0,4,4,1.0,1.0
MCD,0,1,7,2,6,8,0.75,1.0
OKTA,0,0,10,0,10,10,1.0,1.0
SP,3,10,2,13,2,15,0.1333,0.1
MSTR,5,11,8,14,10,24,0.4167,0.0909
LFST,1,1,3,3,2,5,0.4,1.0
THC,3,0,2,2,3,5,0.6,1.0
PATK,1,2,2,4,1,5,0.2,0.5
NAMS,4,3,3,4,6,10,0.6,0.3333
MPWR,3,1,4,1,7,8,0.875,1.0
EWY,9,3,4,9,7,16,0.4375,0.3333
VEON,0,2,3,4,1,5,0.2,0.5
IIIV,2,1,2,1,4,5,0.8,1.0
AVGO,1,1,12,2,12,14,0.8571,1.0
PLAY,7,1,2,4,6,10,0.6,1.0
CFR,5,2,3,3,7,10,0.7,0.5
ASYS,2,1,2,3,2,5,0.4,1.0
JLL,0,1,4,2,3,5,0.6,1.0
FCEL,1,1,3,2,3,5,0.6,1.0
COST,2,5,10,8,9,17,0.5294,0.2
RH,3,0,10,2,11,13,0.8462,1.0
RHI,1,0,4,1,4,5,0.8,1.0
PEP,1,1,2,1,3,4,0.75,1.0
BLUE,5,1,3,2,7,9,0.7778,1.0
WDC,1,1,2,2,2,4,0.5,1.0
EMLAF,1,1,3,2,3,5,0.6,1.0
APA,3,2,5,5,5,10,0.5,0.5
NDSN,3,1,6,2,8,10,0.8,1.0
MTCH,4,1,4,4,5,9,0.5556,1.0
LQDT,0,1,4,3,2,5,0.4,1.0
CCCS,0,1,4,2,3,5,0.6,1.0
KEYUF,0,1,4,1,4,5,0.8,1.0
JILL,0,3,2,3,2,5,0.4,0.3333
UEC,2,1,1,3,1,4,0.25,1.0
ML,2,4,3,6,3,9,0.3333,0.25
MYNA,4,1,0,1,4,5,0.8,1.0
OLLI,2,4,13,4,15,19,0.7895,0.25
CMCSA,1,4,4,4,5,9,0.5556,0.25
IDEXY,2,1,7,7,3,10,0.3,1.0
BZ,0,2,8,4,6,10,0.6,0.5
LOVE,0,1,9,2,8,10,0.8,1.0
SLF,0,0,5,0,5,5,1.0,1.0
NA,0,1,3,1,3,4,0.75,1.0
GME,4,0,5,2,7,9,0.7778,1.0
TOL,4,4,9,5,12,17,0.7059,0.25
SPFI,2,2,1,2,3,5,0.6,0.5
DESP,1,3,6,4,6,10,0.6,0.3333
ASHTF,4,1,0,1,4,5,0.8,1.0
MFG,0,3,5,3,5,8,0.625,0.3333
ANET,1,5,7,8,5,13,0.3846,0.2
FLAX,1,5,0,6,0,6,0.0,0.2
HOPHF,0,4,0,4,0,4,0.0,0.25
SPWH,1,1,3,2,3,5,0.6,1.0
GIII,1,0,4,3,2,5,0.4,1.0
FERG,1,5,4,9,1,10,0.1,0.2
AQST,5,1,9,3,12,15,0.8,1.0
EMR,0,4,9,5,8,13,0.6154,0.25
CRVO,4,1,0,1,4,5,0.8,1.0
ASO,5,3,2,5,5,10,0.5,0.3333
UNFI,1,1,3,2,3,5,0.6,1.0
MDB,2,5,7,8,6,14,0.4286,0.2
HQY,2,1,6,3,6,9,0.6667,1.0
YEXT,1,0,3,1,3,4,0.75,1.0
BIIB,7,2,6,6,9,15,0.6,0.5
DLO,4,2,4,2,8,10,0.8,0.5
AZO,3,1,9,4,9,13,0.6923,1.0
NOMD,1,0,4,0,5,5,1.0,1.0
M,4,4,5,7,6,13,0.4615,0.25
PFIS,1,2,2,2,3,5,0.6,0.5
RENT,1,1,3,2,3,5,0.6,1.0
VBNK,2,0,3,2,3,5,0.6,1.0
YPF,1,0,2,0,3,3,1.0,1.0
QCOM,6,3,19,11,17,28,0.6071,0.3333
BWMN,0,0,5,3,2,5,0.4,1.0
XBI,0,2,5,3,4,7,0.5714,0.5
BYD.TO,0,2,12,3,11,14,0.7857,0.5
IEUR,0,3,5,4,4,8,0.5,0.3333
GBDC,0,6,6,7,5,12,0.4167,0.1667
DGT,4,20,8,26,6,32,0.1875,0.05
ELAN,3,2,0,3,2,5,0.4,0.5
PHR,1,0,3,2,2,4,0.5,1.0
XTL,0,5,6,10,1,11,0.0909,0.2
BLDG,0,2,3,3,2,5,0.4,0.5
UFO,1,4,0,5,0,5,0.0,0.25
KER.PA,4,1,1,2,4,6,0.6667,1.0
EUFN,2,3,2,6,1,7,0.1429,0.3333
SPLP,0,0,10,2,8,10,0.8,1.0
EWTX,2,1,1,1,3,4,0.75,1.0
CNK,1,1,2,1,3,4,0.75,1.0
ASAN,0,0,4,0,4,4,1.0,1.0
DOCU,0,0,4,0,4,4,1.0,1.0
GTLB,0,1,7,1,7,8,0.875,1.0
HPE,4,3,12,4,15,19,0.7895,0.3333
IOT,1,0,9,2,8,10,0.8,1.0
ULTA,5,1,12,4,14,18,0.7778,1.0
BF-B,0,0,5,2,3,5,0.6,1.0
KR,1,1,8,3,7,10,0.7,1.0
ETR,0,4,1,4,1,5,0.2,0.25
GDRX,4,2,4,2,8,10,0.8,0.5
BBW,0,1,4,2,3,5,0.6,1.0
LE,3,0,2,1,4,5,0.8,1.0
CSIQ,6,0,4,0,10,10,1.0,1.0
FIVE,5,3,5,4,9,13,0.6923,0.3333
PVH,3,0,1,0,4,4,1.0,1.0
CHPT,3,0,1,1,3,4,0.75,1.0
GMS,2,1,1,1,3,4,0.75,1.0
DG,2,1,2,1,4,5,0.8,1.0
LAKE,0,1,4,2,3,5,0.6,1.0
CASY,1,1,2,3,1,4,0.25,1.0
GEF,1,3,1,3,2,5,0.4,0.3333
DLMAF,0,1,4,1,4,5,0.8,1.0
AEO,1,1,2,3,1,4,0.25,1.0
HRL,3,1,1,3,2,5,0.4,1.0
TOST,1,0,4,1,4,5,0.8,1.0
DLTR,3,2,4,3,6,9,0.6667,0.5
HOOD,2,3,13,5,13,18,0.7222,0.3333
PSTG,1,2,9,5,7,12,0.5833,0.5
MRVL,5,5,11,8,13,21,0.619,0.2
CPB,7,2,6,3,12,15,0.8,0.5
BMY,4,0,1,1,4,5,0.8,1.0
EURL,5,1,2,2,6,8,0.75,1.0
OIL,0,0,2,2,0,2,0.0,1.0
FLUX,10,2,3,5,10,15,0.6667,0.5
CURV,6,1,3,6,4,10,0.4,1.0
BOX,1,3,6,4,6,10,0.6,0.3333
BASE,1,1,3,2,3,5,0.6,1.0
CTRN,0,0,5,0,5,5,1.0,1.0
AFL,0,0,4,2,2,4,0.5,1.0
SHOP,0,0,10,0,10,10,1.0,1.0
VRT,2,0,6,2,6,8,0.75,1.0
FL,3,3,2,4,4,8,0.5,0.3333
NARI,1,1,3,1,4,5,0.8,1.0
BNS,2,5,3,6,4,10,0.4,0.2
ZS,8,4,7,6,13,19,0.6842,0.25
WEC,0,0,3,1,2,3,0.6667,1.0
PROSY,1,0,4,0,5,5,1.0,1.0
CRDO,1,1,2,1,3,4,0.75,1.0
ALCO,1,1,3,2,3,5,0.6,1.0
ZUO,3,2,0,2,3,5,0.6,0.5
SLX,5,5,7,8,9,17,0.5294,0.2
QQQM,8,31,18,44,13,57,0.2281,0.0323
HHF.TO,0,6,6,7,5,12,0.4167,0.1667
AILE,6,3,1,3,7,10,0.7,0.3333
LSPD,1,1,2,1,3,4,0.75,1.0
IBRX,3,1,6,4,6,10,0.6,1.0
IMPP,3,0,2,1,4,5,0.8,1.0
DSGX,0,0,5,0,5,5,1.0,1.0
DCI,0,0,5,0,5,5,1.0,1.0
CHH,2,3,5,5,5,10,0.5,0.3333
ZG,0,0,3,0,3,3,1.0,1.0
NU,2,3,11,4,12,16,0.75,0.3333
SYK,0,0,4,0,4,4,1.0,1.0
SQ,2,0,10,2,10,12,0.8333,1.0
SOXX,4,3,1,7,1,8,0.125,0.3333
AIQ,2,8,10,14,6,20,0.3,0.125
CHIX,0,2,3,3,2,5,0.4,0.5
IYR,0,4,5,6,3,9,0.3333,0.25
INDY,2,1,0,1,2,3,0.6667,1.0
IYH,5,0,1,2,4,6,0.6667,1.0
STLA,1,4,1,5,1,6,0.1667,0.25
LTCUSD,0,4,3,4,3,7,0.4286,0.25
HBA.TO,4,3,0,4,3,7,0.4286,0.3333
KSA,1,2,0,2,1,3,0.3333,0.5
AX,2,4,9,8,7,15,0.4667,0.25
BGNE,1,1,2,2,2,4,0.5,1.0
PTCT,2,0,3,2,3,5,0.6,1.0
BIOR,2,1,2,1,4,5,0.8,1.0
CABA,0,2,5,2,5,7,0.7143,0.5
WYHG,1,1,2,2,2,4,0.5,1.0
MNSO,0,5,5,7,3,10,0.3,0.2
CNTMF,2,1,2,2,3,5,0.6,1.0
CLSK,2,2,1,3,2,5,0.4,0.5
NAT,2,1,2,3,2,5,0.4,1.0
ADSK,7,2,9,4,14,18,0.7778,0.5
DDD,0,0,3,0,3,3,1.0,1.0
BIDU,10,7,15,15,17,32,0.5312,0.1429
FGF,1,3,1,4,1,5,0.2,0.3333
RSGUF,1,1,3,3,2,5,0.4,1.0
GOGL,0,1,4,2,3,5,0.6,1.0
MGROF,1,1,3,3,2,5,0.4,1.0
FRO,3,3,4,6,4,10,0.4,0.3333
CMPGY,0,0,5,1,4,5,0.8,1.0
IMMR,2,1,2,2,3,5,0.6,1.0
BBY,3,2,0,2,3,5,0.6,0.5
AXS,0,0,4,1,3,4,0.75,1.0
CLVR,0,1,4,2,3,5,0.6,1.0
DELL,15,4,8,9,18,27,0.6667,0.25
HPQ,2,0,2,1,3,4,0.75,1.0
JWN,3,1,10,4,10,14,0.7143,1.0
NTNX,1,0,7,1,7,8,0.875,1.0
DB,6,4,9,7,12,19,0.6316,0.25
SJM,4,3,3,3,7,10,0.7,0.3333
WDAY,2,0,8,2,8,10,0.8,1.0
DKS,4,1,8,5,8,13,0.6154,1.0
WWD,0,3,9,5,7,12,0.5833,0.3333
ZM,3,1,10,2,12,14,0.8571,1.0
A,5,2,6,4,9,13,0.6923,0.5
HUBB,2,0,1,1,2,3,0.6667,1.0
RMBS,0,0,2,0,2,2,1.0,1.0
LESL,3,1,1,1,4,5,0.8,1.0
BLBD,0,2,8,2,8,10,0.8,0.5
AFRM,0,1,7,2,6,8,0.75,1.0
BSX,3,4,3,5,5,10,0.5,0.25
YY,0,1,4,1,4,5,0.8,1.0
FXLV,0,2,5,2,5,7,0.7143,0.5
BBWI,3,3,3,4,5,9,0.5556,0.3333
CWEN,0,0,2,0,2,2,1.0,1.0
URBN,1,2,2,2,3,5,0.6,0.5
BURL,1,1,3,3,2,5,0.4,1.0
AGZ,0,4,4,6,2,8,0.25,0.25
USDTUSD,0,1,6,3,4,7,0.5714,1.0
ANF,0,2,3,2,3,5,0.6,0.5
GPUS,1,3,1,5,0,5,0.0,0.3333
PFBC,4,3,3,4,6,10,0.6,0.3333
ADMA,2,2,1,4,1,5,0.2,0.5
SCVL,2,1,2,2,3,5,0.6,1.0
PG,6,5,4,5,10,15,0.6667,0.2
CPA,3,1,5,5,4,9,0.4444,1.0
ATR,0,2,3,2,3,5,0.6,0.5
NMHI,1,1,2,4,0,4,0.0,1.0
LIFWZ,4,1,0,1,4,5,0.8,1.0
WMG,2,0,2,1,3,4,0.75,1.0
ROST,1,1,7,4,5,9,0.5556,1.0
NTAP,0,2,13,3,12,15,0.8,0.5
DE,7,4,3,5,9,14,0.6429,0.25
BJ,0,1,3,1,3,4,0.75,1.0
AVPT,0,2,2,2,2,4,0.5,0.5
INTU,2,1,7,2,8,10,0.8,1.0
TCBI,1,2,2,3,2,5,0.4,0.5
BKE,3,0,2,2,3,5,0.6,1.0
IAS,0,1,9,2,8,10,0.8,1.0
DY,1,1,3,1,4,5,0.8,1.0
DBX,2,2,3,3,4,7,0.5714,0.5
MMS,1,1,3,2,3,5,0.6,1.0
SR,3,1,1,3,2,5,0.4,1.0
NIO,6,5,13,9,15,24,0.625,0.2
TJX,3,0,11,2,12,14,0.8571,1.0
TGT,9,6,5,7,13,20,0.65,0.1667
WIX,0,0,4,0,4,4,1.0,1.0
HDGE.TO,0,0,1,0,1,1,1.0,1.0
LUXH,1,1,2,2,2,4,0.5,1.0
ROAD,1,2,2,2,3,5,0.6,0.5
DRVN,0,1,4,2,3,5,0.6,1.0
AIM,2,1,2,2,3,5,0.6,1.0
LOW,7,2,8,4,13,17,0.7647,0.5
MDT,1,1,3,2,3,5,0.6,1.0
GFS,1,0,2,1,2,3,0.6667,1.0
BOOM,4,0,0,1,3,4,0.75,1.0
ENR,0,0,3,1,2,3,0.6667,1.0
AS,0,0,3,0,3,3,1.0,1.0
MIGI,3,0,2,1,4,5,0.8,1.0
VFS,12,2,6,6,14,20,0.7,0.5
ZIM,1,0,4,2,3,5,0.6,1.0
FUTU,1,1,6,4,4,8,0.5,1.0
TCOM,0,1,8,2,7,9,0.7778,1.0
FENC,1,2,2,3,2,5,0.4,0.5
JACK,4,0,4,2,6,8,0.75,1.0
XRAY,3,0,1,1,3,4,0.75,1.0
FIX,0,1,2,1,2,3,0.6667,1.0
SAVE,0,2,13,2,13,15,0.8667,0.5
FI,0,0,3,0,3,3,1.0,1.0
MGIC,0,0,3,0,3,3,1.0,1.0
XPEV,0,0,5,1,4,5,0.8,1.0
VIPS,2,1,2,1,4,5,0.8,1.0
AWK,0,0,5,3,2,5,0.4,1.0
EZPW,1,0,4,2,3,5,0.6,1.0
GSBD,6,18,4,21,7,28,0.25,0.0556
BKKT,2,3,10,5,10,15,0.6667,0.3333
MDCX,1,1,3,2,3,5,0.6,1.0
SBLK,2,2,6,4,6,10,0.6,0.5
ZETA,2,1,6,3,6,9,0.6667,1.0
BFAM,2,0,1,0,3,3,1.0,1.0
MRNA,2,1,6,4,5,9,0.5556,1.0
ANY,1,0,4,1,4,5,0.8,1.0
BTBT,1,0,4,0,5,5,1.0,1.0
GLNG,0,2,3,4,1,5,0.2,0.5
J,0,2,3,3,2,5,0.4,0.5
JMSB,2,1,2,2,3,5,0.6,1.0
ACM,0,2,3,2,3,5,0.6,0.5
WLK,0,0,5,3,2,5,0.4,1.0
ORGN,2,1,1,1,3,4,0.75,1.0
AGEN,3,1,1,1,4,5,0.8,1.0
SYF,2,1,2,2,3,5,0.6,1.0
KRON,3,0,2,2,3,5,0.6,1.0
DDS,1,1,3,2,3,5,0.6,1.0
BN,0,0,5,0,5,5,1.0,1.0
IBTA,1,0,3,0,4,4,1.0,1.0
POST,0,1,4,2,3,5,0.6,1.0
NICE,1,0,4,0,5,5,1.0,1.0
SBH,1,4,4,5,4,9,0.4444,0.25
GLOB,1,0,3,0,4,4,1.0,1.0
DOCS,0,0,3,0,3,3,1.0,1.0
AAP,4,0,0,0,4,4,1.0,1.0
BE,1,0,3,1,3,4,0.75,1.0
SYM,1,2,1,3,1,4,0.25,0.5
SRTS,0,1,4,1,4,5,0.8,1.0
AEYE,2,0,3,1,4,5,0.8,1.0
MPTI,3,0,3,1,5,6,0.8333,1.0
FLYW,2,1,1,3,1,4,0.25,1.0
TLSI,3,2,0,2,3,5,0.6,0.5
ASA,1,2,2,4,1,5,0.2,0.5
STTK,5,0,0,1,4,5,0.8,1.0
IDN,2,0,2,0,4,4,1.0,1.0
ALTG,6,3,1,5,5,10,0.5,0.3333
CSCO,2,2,5,4,5,9,0.5556,0.5
CIX,4,1,0,1,4,5,0.8,1.0
HI,4,0,1,0,5,5,1.0,1.0
FOUR,1,0,4,2,3,5,0.6,1.0
CYBR,1,1,6,1,7,8,0.875,1.0
SONO,2,0,1,0,3,3,1.0,1.0
CTRA,0,0,4,0,4,4,1.0,1.0
BLNK,3,1,0,1,3,4,0.75,1.0
ROIV,2,1,2,1,4,5,0.8,1.0
JD,0,2,3,2,3,5,0.6,0.5
REGN,2,1,2,3,2,5,0.4,1.0
XOS,2,1,2,2,3,5,0.6,1.0
BRBR,1,2,2,3,2,5,0.4,0.5
SPB,3,1,1,2,3,5,0.6,1.0
VERO,4,1,0,1,4,5,0.8,1.0
PANL,1,0,4,2,3,5,0.6,1.0
MRSN,2,0,3,2,3,5,0.6,1.0
GILD,1,0,4,2,3,5,0.6,1.0
ICUI,0,0,5,1,4,5,0.8,1.0
TGI,1,1,2,1,3,4,0.75,1.0
ALIT,2,1,2,2,3,5,0.6,1.0
MOS,2,0,3,1,4,5,0.8,1.0
AAON,1,2,2,4,1,5,0.2,0.5
HD,3,2,8,4,9,13,0.6923,0.5
AXSM,2,0,3,1,4,5,0.8,1.0
ZI,3,0,1,1,3,4,0.75,1.0
NTRA,0,0,3,0,3,3,1.0,1.0
CAVA,0,0,9,0,9,9,1.0,1.0
MARA,3,0,1,0,4,4,1.0,1.0
NSSC,2,2,6,5,5,10,0.5,0.5
TEO,1,1,2,2,2,4,0.5,1.0
GRPN,1,2,2,2,3,5,0.6,0.5
GPS,0,1,4,3,2,5,0.4,1.0
AGO,1,2,2,3,2,5,0.4,0.5
IAC,2,2,6,4,6,10,0.6,0.5
MNDY,1,1,3,3,2,5,0.4,1.0
LYV,3,1,5,4,5,9,0.5556,1.0
PGNY,3,3,4,3,7,10,0.7,0.3333
ARMK,2,3,0,3,2,5,0.4,0.3333
SHLS,2,0,1,1,2,3,0.6667,1.0
CMTG,2,3,3,4,4,8,0.5,0.3333
BR,0,2,3,4,1,5,0.2,0.5
LSCC,2,1,2,1,4,5,0.8,1.0
MIRM,1,1,3,2,3,5,0.6,1.0
TSVT,2,2,0,2,2,4,0.5,0.5
NRSNW,6,0,0,2,4,6,0.6667,1.0
LAZR,1,0,3,0,4,4,1.0,1.0
CMG,3,4,3,5,5,10,0.5,0.25
WMS,1,0,1,0,2,2,1.0,1.0
FBND,2,6,0,7,1,8,0.125,0.1667
CHIE,1,7,11,12,7,19,0.3684,0.1429
JGLD,2,6,1,7,2,9,0.2222,0.1667
VNM,0,4,5,5,4,9,0.4444,0.25
MCHI,0,4,5,4,5,9,0.5556,0.25
EC,1,0,4,2,3,5,0.6,1.0
ME,2,1,2,2,3,5,0.6,1.0
PPL,0,2,3,3,2,5,0.4,0.5
ALC,0,1,3,1,3,4,0.75,1.0
SVCO,1,2,2,4,1,5,0.2,0.5
LNZA,2,1,1,1,3,4,0.75,1.0
WES,1,3,1,4,1,5,0.2,0.3333
BX,0,1,7,1,7,8,0.875,1.0
FTRE,2,1,1,2,2,4,0.5,1.0
AMCX,5,0,0,1,4,5,0.8,1.0
PARA,4,1,4,5,4,9,0.4444,1.0
DNA,2,1,2,2,3,5,0.6,1.0
AGL,3,0,0,0,3,3,1.0,1.0
VALE,1,1,1,2,1,3,0.3333,1.0
SMAR,1,0,1,1,1,2,0.5,1.0
CE,2,0,0,0,2,2,1.0,1.0
ATMU,0,1,3,1,3,4,0.75,1.0
MLNK,0,0,2,0,2,2,1.0,1.0
OMCL,2,1,0,1,2,3,0.6667,1.0
AMH,0,2,2,4,0,4,0.0,0.5
TM,1,4,8,6,7,13,0.5385,0.25
FLEE,0,5,3,6,2,8,0.25,0.2
SHIBUSD,0,5,5,5,5,10,0.5,0.2
IQM,0,2,9,6,5,11,0.4545,0.5
RKLB,3,1,6,2,8,10,0.8,1.0
RDNT,1,2,1,4,0,4,0.0,0.5
EXFY,1,1,2,2,2,4,0.5,1.0
DH,1,0,4,2,3,5,0.6,1.0
TSBX,3,1,0,1,3,4,0.75,1.0
BHVN,1,1,3,1,4,5,0.8,1.0
STRO,0,1,3,3,1,4,0.25,1.0
III,1,1,2,2,2,4,0.5,1.0
LWAY,0,0,5,0,5,5,1.0,1.0
IGMS,3,1,0,1,3,4,0.75,1.0
NUTX,2,0,2,0,4,4,1.0,1.0
SBT,2,2,1,3,2,5,0.4,0.5
OPAL,1,1,3,2,3,5,0.6,1.0
DKNG,7,2,1,3,7,10,0.7,0.5
GCT,0,1,4,1,4,5,0.8,1.0
DRH,1,2,2,3,2,5,0.4,0.5
ZD,0,0,5,1,4,5,0.8,1.0
MTUS,3,0,2,2,3,5,0.6,1.0
VCTR,0,2,3,4,1,5,0.2,0.5
TTD,3,4,1,4,4,8,0.5,0.25
MTD,0,1,4,1,4,5,0.8,1.0
ALKT,1,1,3,4,1,5,0.2,1.0
PEB,2,1,7,2,8,10,0.8,1.0
CIVI,1,2,2,3,2,5,0.4,0.5
KOP,2,0,3,1,4,5,0.8,1.0
YMAB,4,0,1,2,3,5,0.6,1.0
ABNB,3,2,3,3,5,8,0.625,0.5
CGC,3,0,2,1,4,5,0.8,1.0
LCID,0,0,5,1,4,5,0.8,1.0
XERS,0,2,3,2,3,5,0.6,0.5
WPM,0,2,3,2,3,5,0.6,0.5
RLJ,0,1,4,1,4,5,0.8,1.0
PAHC,1,1,3,2,3,5,0.6,1.0
RCMT,1,1,3,3,2,5,0.4,1.0
ARRY,4,0,0,1,3,4,0.75,1.0
ALNT,1,0,4,2,3,5,0.6,1.0
MKSI,0,0,5,2,3,5,0.6,1.0
GRMN,0,0,8,0,8,8,1.0,1.0
MTSI,1,0,4,1,4,5,0.8,1.0
MWFLX,0,2,5,2,5,7,0.7143,0.5
TPVG,2,1,1,2,2,4,0.5,1.0
DCO,0,2,3,3,2,5,0.4,0.5
FSLY,0,1,3,1,3,4,0.75,1.0
ARM,2,0,2,1,3,4,0.75,1.0
COTY,3,0,1,0,4,4,1.0,1.0
TRIP,2,0,1,2,1,3,0.3333,1.0
Z,0,0,3,1,2,3,0.6667,1.0
XNCR,2,1,2,1,4,5,0.8,1.0
SITC,1,2,2,2,3,5,0.6,0.5
WTI,2,2,1,3,2,5,0.4,0.5
STRL,0,2,3,3,2,5,0.4,0.5
HUBS,0,0,4,2,2,4,0.5,1.0
ASH,0,2,3,4,1,5,0.2,0.5
CLNE,0,0,5,2,3,5,0.6,1.0
CLVT,5,0,0,0,5,5,1.0,1.0
JAZZ,1,1,3,2,3,5,0.6,1.0
ACGL,1,0,3,1,3,4,0.75,1.0
ARIS,0,1,4,3,2,5,0.4,1.0
STWD,1,1,3,1,4,5,0.8,1.0
PINS,1,0,9,2,8,10,0.8,1.0
CELH,1,0,4,0,5,5,1.0,1.0
MCHP,3,0,0,0,3,3,1.0,1.0
TME,0,0,3,0,3,3,1.0,1.0
IFF,1,1,6,2,6,8,0.75,1.0
DVN,2,0,5,2,5,7,0.7143,1.0
LUMN,1,0,7,0,8,8,1.0,1.0
NTB,1,1,3,1,4,5,0.8,1.0
IONS,0,1,4,1,4,5,0.8,1.0
PAYO,0,2,3,3,2,5,0.4,0.5
SHC,2,1,1,2,2,4,0.5,1.0
CRUS,1,0,3,0,4,4,1.0,1.0
APO,0,0,5,1,4,5,0.8,1.0
NYT,2,0,7,1,8,9,0.8889,1.0
FOXA,1,1,10,4,8,12,0.6667,1.0
INTA,2,1,2,1,4,5,0.8,1.0
MODG,1,1,3,1,4,5,0.8,1.0
PTLO,1,2,2,2,3,5,0.6,0.5
DEA,1,1,3,2,3,5,0.6,1.0
GT,1,0,3,1,3,4,0.75,1.0
EGHT,1,0,2,0,3,3,1.0,1.0
ILMN,3,0,2,0,5,5,1.0,1.0
MQ,2,0,1,0,3,3,1.0,1.0
CMS,0,0,2,0,2,2,1.0,1.0
HOLX,0,0,4,1,3,4,0.75,1.0
BCC,2,2,1,3,2,5,0.4,0.5
HHH,1,0,4,2,3,5,0.6,1.0
GOOD,2,1,2,2,3,5,0.6,1.0
FANG,2,4,1,6,1,7,0.1429,0.25
GLT,1,2,1,3,1,4,0.25,0.5
MED,1,0,3,2,2,4,0.5,1.0
CNTY,3,0,2,1,4,5,0.8,1.0
EXAS,0,0,5,1,4,5,0.8,1.0
ASM,1,1,3,2,3,5,0.6,1.0
RVTY,2,3,0,3,2,5,0.4,0.3333
PEG,2,0,1,1,2,3,0.6667,1.0
MAR,2,1,4,4,3,7,0.4286,1.0
L,2,0,2,0,4,4,1.0,1.0
BRK-B,3,3,9,6,9,15,0.6,0.3333
CEG,1,0,4,0,5,5,1.0,1.0
BAM,0,0,5,1,4,5,0.8,1.0
EXPD,2,1,4,2,5,7,0.7143,1.0
DD,0,0,5,1,4,5,0.8,1.0
CMRE,2,2,6,3,7,10,0.7,0.5
CHD,0,1,4,1,4,5,0.8,1.0
BEN,2,2,0,2,2,4,0.5,0.5
SOHO,0,1,3,2,2,4,0.5,1.0
DBRG,1,2,2,3,2,5,0.4,0.5
NVT,1,3,1,3,2,5,0.4,0.3333
D,2,3,7,7,5,12,0.4167,0.3333
CVX,0,3,6,4,5,9,0.5556,0.3333
BC,7,2,1,4,6,10,0.6,0.5
LYB,2,0,3,1,4,5,0.8,1.0
W,4,0,1,2,3,5,0.6,1.0
SPG,1,0,2,0,3,3,1.0,1.0
XOM,0,2,3,3,2,5,0.4,0.5
TZUP,0,0,4,0,4,4,1.0,1.0
DSGR,1,1,3,2,3,5,0.6,1.0
H,0,1,4,1,4,5,0.8,1.0
SABR,3,1,1,1,4,5,0.8,1.0
SRI,2,1,2,1,4,5,0.8,1.0
SM,3,1,0,3,1,4,0.25,1.0
LIN,0,1,4,1,4,5,0.8,1.0
NOK,0,4,5,7,2,9,0.2222,0.25
HII,5,3,2,4,6,10,0.6,0.3333
WEAV,0,1,4,1,4,5,0.8,1.0
SFM,0,2,2,2,2,4,0.5,0.5
SO,0,0,4,1,3,4,0.75,1.0
EBAY,2,0,2,0,4,4,1.0,1.0
UBER,1,0,6,0,7,7,1.0,1.0
RBLX,0,0,3,0,3,3,1.0,1.0
SBUX,11,1,0,3,9,12,0.75,1.0
ICE,0,2,3,2,3,5,0.6,0.5
GWW,0,2,3,2,3,5,0.6,0.5
ALTR,2,0,2,1,3,4,0.75,1.0
ALE,2,2,1,4,1,5,0.2,0.5
BG,3,1,3,1,6,7,0.8571,1.0
NVCR,2,0,3,0,5,5,1.0,1.0
ORN,2,0,3,0,5,5,1.0,1.0
MKL,1,2,2,2,3,5,0.6,0.5
MGPI,5,0,0,1,4,5,0.8,1.0
PRU,1,1,3,2,3,5,0.6,1.0
SWK,3,1,1,1,4,5,0.8,1.0
TT,0,1,4,2,3,5,0.6,1.0
EXC,0,1,4,2,3,5,0.6,1.0
ARCC,2,3,0,3,2,5,0.4,0.3333
MBLY,1,3,0,3,1,4,0.25,0.3333
GEHC,0,0,5,1,4,5,0.8,1.0
NRDS,0,0,4,0,4,4,1.0,1.0
ABBV,0,0,4,0,4,4,1.0,1.0
ITW,0,0,3,0,3,3,1.0,1.0
KHC,2,0,1,1,2,3,0.6667,1.0
WM,1,4,4,5,4,9,0.4444,0.25
XPO,0,0,5,2,3,5,0.6,1.0
GIC,3,1,1,2,3,5,0.6,1.0
TEL,0,1,3,1,3,4,0.75,1.0
GSK,1,1,2,1,3,4,0.75,1.0
HCRB,0,1,5,2,4,6,0.6667,1.0
PM,0,1,19,1,19,20,0.95,1.0
ESAB,0,1,4,1,4,5,0.8,1.0
MERC,3,0,2,2,3,5,0.6,1.0
SKWD,0,0,5,2,3,5,0.6,1.0
AMT,3,1,0,2,2,4,0.5,1.0
MSCI,2,1,7,3,7,10,0.7,1.0
CROX,0,0,5,1,4,5,0.8,1.0
SYY,1,1,3,2,3,5,0.6,1.0
CPAY,1,0,3,0,4,4,1.0,1.0
CPRT,1,1,7,3,6,9,0.6667,1.0
SC,0,2,7,4,5,9,0.5556,0.5
LTC,0,1,4,1,4,5,0.8,1.0
BRX,1,3,1,3,2,5,0.4,0.3333
CF,2,0,3,3,2,5,0.4,1.0
EHC,0,0,5,0,5,5,1.0,1.0
AMGN,1,2,2,3,2,5,0.4,0.5
BRO,0,0,5,1,4,5,0.8,1.0
WELL,0,4,6,6,4,10,0.4,0.25
SBAC,2,1,7,5,5,10,0.5,1.0
ON,1,2,2,2,3,5,0.6,0.5
BOW,1,1,3,1,4,5,0.8,1.0
JBLU,0,0,5,0,5,5,1.0,1.0
ENSG,1,0,8,2,7,9,0.7778,1.0
PHG,5,0,0,0,5,5,1.0,1.0
BOH,0,0,4,0,4,4,1.0,1.0
OVV,1,0,1,0,2,2,1.0,1.0
CNP,3,1,1,2,3,5,0.6,1.0
SKY,0,1,4,1,4,5,0.8,1.0
BOOT,0,0,5,0,5,5,1.0,1.0
FLJP,4,3,0,3,4,7,0.5714,0.3333
QQQN,1,0,6,3,4,7,0.5714,1.0
EPP,2,4,1,5,2,7,0.2857,0.25
DIA,0,0,9,2,7,9,0.7778,1.0
EA,0,2,3,4,1,5,0.2,0.5
CAKE,1,2,7,7,3,10,0.3,0.5
AKR,1,1,3,3,2,5,0.4,1.0
GNTX,0,0,5,1,4,5,0.8,1.0
CVI,3,1,1,2,3,5,0.6,1.0
SNYR,1,1,2,2,2,4,0.5,1.0
ASGN,1,1,7,3,6,9,0.6667,1.0
CNC,1,0,4,2,3,5,0.6,1.0
SKX,0,0,3,0,3,3,1.0,1.0
COUR,2,0,2,0,4,4,1.0,1.0
DXCM,2,0,1,1,2,3,0.6667,1.0
SAM,2,0,2,0,4,4,1.0,1.0
RMD,0,0,2,0,2,2,1.0,1.0
BNDW,0,4,3,6,1,7,0.1429,0.25
CPRI,1,3,2,4,2,6,0.3333,0.3333
RWR,0,5,7,6,6,12,0.5,0.2
ZYXI,1,2,2,2,3,5,0.6,0.5
TXRH,0,1,4,2,3,5,0.6,1.0
POOL,2,1,2,2,3,5,0.6,1.0
LHX,1,1,8,1,9,10,0.9,1.0
KKR,0,1,4,1,4,5,0.8,1.0
RCUS,1,1,2,1,3,4,0.75,1.0
IBM,11,4,7,8,14,22,0.6364,0.25
HAS,3,0,2,0,5,5,1.0,1.0
POR,0,0,5,0,5,5,1.0,1.0
AON,0,1,4,1,4,5,0.8,1.0
ALLE,1,1,3,3,2,5,0.4,1.0
LRCX,0,0,11,1,10,11,0.9091,1.0
SPR,3,0,1,1,3,4,0.75,1.0
LVS,4,0,0,0,4,4,1.0,1.0
TRU,0,2,3,2,3,5,0.6,0.5
AAL,2,0,3,1,4,5,0.8,1.0
UL,0,2,5,4,3,7,0.4286,0.5
DSY.PA,4,2,1,4,3,7,0.4286,0.5
URI,0,2,3,4,1,5,0.2,0.5
ODFL,2,0,3,0,5,5,1.0,1.0
LII,0,0,5,1,4,5,0.8,1.0
SYBT,1,1,3,2,3,5,0.6,1.0
TNL,0,1,4,2,3,5,0.6,1.0
HAFC,0,2,3,3,2,5,0.4,0.5
CME,0,0,5,0,5,5,1.0,1.0
TMO,3,0,2,3,2,5,0.4,1.0
EWBC,1,2,2,3,2,5,0.4,0.5
TFII,2,0,3,1,4,5,0.8,1.0
"QCOM, NASDAQ",3,1,0,1,3,4,0.75,1.0
ALGN,2,0,3,1,4,5,0.8,1.0
WEX,1,2,2,4,1,5,0.2,0.5
NBR,4,0,1,1,4,5,0.8,1.0
NSC,0,1,4,1,4,5,0.8,1.0
KTOS,0,1,3,1,3,4,0.75,1.0
PHM,2,0,2,0,4,4,1.0,1.0
HSTM,0,1,4,2,3,5,0.6,1.0
AUB,0,2,3,3,2,5,0.4,0.5
CLB,1,0,4,0,5,5,1.0,1.0
RAND.AS,0,1,7,3,5,8,0.625,1.0
IHG,0,1,9,2,8,10,0.8,1.0
SAP,0,1,9,1,9,10,0.9,1.0
LOGI,0,2,8,2,8,10,0.8,0.5
MCO,0,3,8,3,8,11,0.7273,0.3333
HDB,0,3,2,3,2,5,0.4,0.3333
ACWF,2,3,5,7,3,10,0.3,0.3333
EFSC,0,0,5,1,4,5,0.8,1.0
WHR,2,1,2,3,2,5,0.4,1.0
SASR,2,1,1,1,3,4,0.75,1.0
NUE,5,0,4,1,8,9,0.8889,1.0
ARE,1,3,6,6,4,10,0.4,0.3333
RACE,1,1,3,1,4,5,0.8,1.0
GNRC,1,0,3,0,4,4,1.0,1.0
CVS,1,1,8,1,9,10,0.9,1.0
HTZ,3,0,1,0,4,4,1.0,1.0
CVRX,1,1,2,1,3,4,0.75,1.0
STLD,5,2,3,3,7,10,0.7,0.5
ALV,3,1,0,2,2,4,0.5,1.0
UPS,4,2,2,2,6,8,0.75,0.5
PAC,0,0,4,1,3,4,0.75,1.0
GOOS,4,0,1,1,4,5,0.8,1.0
CADE,0,2,3,2,3,5,0.6,0.5
ELS,1,3,1,3,2,5,0.4,0.3333
BMI,1,0,3,0,4,4,1.0,1.0
MMC,0,1,4,1,4,5,0.8,1.0
AVY,0,0,4,0,4,4,1.0,1.0
SE,0,0,4,0,4,4,1.0,1.0
ASML,11,5,0,6,10,16,0.625,0.2
MC.PA,10,3,3,7,9,16,0.5625,0.3333
APAM,2,3,6,6,5,11,0.4545,0.3333
ASML.AS,6,4,1,6,5,11,0.4545,0.25
IRDM,0,4,1,4,1,5,0.2,0.25
EFX,0,1,4,1,4,5,0.8,1.0
HTHT,0,0,5,0,5,5,1.0,1.0
TWN,0,3,7,3,7,10,0.7,0.3333
BND,2,5,3,7,3,10,0.3,0.2
CAT,3,0,0,0,3,3,1.0,1.0
VFC,0,0,3,0,3,3,1.0,1.0
FROG,0,0,2,0,2,2,1.0,1.0
YELP,1,0,3,1,3,4,0.75,1.0
EEM,1,5,3,7,2,9,0.2222,0.2
APPF,0,0,5,2,3,5,0.6,1.0
ALTM,2,0,3,2,3,5,0.6,1.0
ESE,1,0,4,1,4,5,0.8,1.0
BMRC,0,0,2,0,2,2,1.0,1.0
